"lang"
{
"Language"	"hungarian"
"Tokens"
{
"TF_BlueTeam"	"&3 BLU"
"[english]TF_BlueTeam"	"&3 BLU"
"TF_RedTeam"	"&4 RED"
"[english]TF_RedTeam"	"&4 RED"
"TF_Observer"	"NÉZŐ"
"[english]TF_Observer"	"OBSERVER"
"TF_Random"	"VÉLETLEN"
"[english]TF_Random"	"RANDOM"
"TF_BlueTeam_Name"	"BLU"
"[english]TF_BlueTeam_Name"	"BLU"
"TF_RedTeam_Name"	"RED"
"[english]TF_RedTeam_Name"	"RED"
"TF_Scout"	"SCOUT"
"[english]TF_Scout"	"SCOUT"
"TF_Sniper"	"SNIPER"
"[english]TF_Sniper"	"SNIPER"
"TF_Soldier"	"SOLDIER"
"[english]TF_Soldier"	"SOLDIER"
"TF_Demoman"	"DEMOMAN"
"[english]TF_Demoman"	"DEMOMAN"
"TF_Medic"	"MEDIC"
"[english]TF_Medic"	"MEDIC"
"TF_HWGuy"	"HEAVY"
"[english]TF_HWGuy"	"HEAVY"
"TF_Pyro"	"PYRO"
"[english]TF_Pyro"	"PYRO"
"TF_Spy"	"SPY"
"[english]TF_Spy"	"SPY"
"TF_Engineer"	"ENGINEER"
"[english]TF_Engineer"	"ENGINEER"
"TF_Class_Name_Scout"	"Scout"
"[english]TF_Class_Name_Scout"	"Scout"
"TF_Class_Name_Sniper"	"Sniper"
"[english]TF_Class_Name_Sniper"	"Sniper"
"TF_Class_Name_Soldier"	"Soldier"
"[english]TF_Class_Name_Soldier"	"Soldier"
"TF_Class_Name_Demoman"	"Demoman"
"[english]TF_Class_Name_Demoman"	"Demoman"
"TF_Class_Name_Medic"	"Medic"
"[english]TF_Class_Name_Medic"	"Medic"
"TF_Class_Name_HWGuy"	"Heavy"
"[english]TF_Class_Name_HWGuy"	"Heavy"
"TF_Class_Name_Pyro"	"Pyro"
"[english]TF_Class_Name_Pyro"	"Pyro"
"TF_Class_Name_Spy"	"Spy"
"[english]TF_Class_Name_Spy"	"Spy"
"TF_Class_Name_Engineer"	"Engineer"
"[english]TF_Class_Name_Engineer"	"Engineer"
"TF_ScoreBoard_Blue"	"BLU"
"[english]TF_ScoreBoard_Blue"	"BLU"
"TF_ScoreBoard_Red"	"RED"
"[english]TF_ScoreBoard_Red"	"RED"
"TF_ScoreBoard_Player"	"%s1 játékos"
"[english]TF_ScoreBoard_Player"	"%s1 player"
"TF_ScoreBoard_Players"	"%s1 játékos"
"[english]TF_ScoreBoard_Players"	"%s1 players"
"ScoreBoard_Spectator"	"%s1 néző: %s2"
"[english]ScoreBoard_Spectator"	"%s1 spectator: %s2"
"ScoreBoard_Spectators"	"%s1 néző: %s2"
"[english]ScoreBoard_Spectators"	"%s1 spectators: %s2"
"TF_ScoreBoard_DEAD"	"HALOTT"
"[english]TF_ScoreBoard_DEAD"	"DEAD"
"TF_Scoreboard_Name"	"Név"
"[english]TF_Scoreboard_Name"	"Name"
"TF_Scoreboard_Score"	"Pontszám"
"[english]TF_Scoreboard_Score"	"Score"
"TF_Scoreboard_Ping"	"Ping"
"[english]TF_Scoreboard_Ping"	"Ping"
"TF_Scoreboard_Bot"	"BOT"
"[english]TF_Scoreboard_Bot"	"BOT"
"TF_ScoreBoard_Point"	"%s1 pont"
"[english]TF_ScoreBoard_Point"	"%s1 point"
"TF_ScoreBoard_Points"	"%s1 pont"
"[english]TF_ScoreBoard_Points"	"%s1 points"
"TF_ScoreBoard_KillsLabel"	"Ölések:"
"[english]TF_ScoreBoard_KillsLabel"	"Kills:"
"TF_ScoreBoard_DeathsLabel"	"Halálok:"
"[english]TF_ScoreBoard_DeathsLabel"	"Deaths:"
"TF_ScoreBoard_CapturesLabel"	"Foglalások:"
"[english]TF_ScoreBoard_CapturesLabel"	"Captures:"
"TF_ScoreBoard_DefensesLabel"	"Védések:"
"[english]TF_ScoreBoard_DefensesLabel"	"Defenses:"
"TF_ScoreBoard_RevengeLabel"	"Bosszúk:"
"[english]TF_ScoreBoard_RevengeLabel"	"Revenge:"
"TF_ScoreBoard_HealingLabel"	"Gyógyítás:"
"[english]TF_ScoreBoard_HealingLabel"	"Healing:"
"TF_ScoreBoard_TeleportsLabel"	"Teleportálások:"
"[english]TF_ScoreBoard_TeleportsLabel"	"Teleports:"
"TF_ScoreBoard_HeadshotsLabel"	"Fejlövések:"
"[english]TF_ScoreBoard_HeadshotsLabel"	"Headshots:"
"TF_ScoreBoard_BonusLabel"	"Bónusz:"
"[english]TF_ScoreBoard_BonusLabel"	"Bonus:"
"TF_ScoreBoard_DamageLabel"	"Sebzés:"
"[english]TF_ScoreBoard_DamageLabel"	"Damage:"
"Scoreboard_Server"	"Szerver: %s1"
"[english]Scoreboard_Server"	"Server: %s1"
"Scoreboard_TimeLeft"	"Hátralevő pályaidő a szerveren: %s1:%s2:%s3"
"[english]Scoreboard_TimeLeft"	"Server map time left: %s1:%s2:%s3"
"Scoreboard_TimeLeftNoHours"	"Hátralevő pályaidő a szerveren: %s1:%s2"
"[english]Scoreboard_TimeLeftNoHours"	"Server map time left: %s1:%s2"
"Scoreboard_NoTimeLimit"	"Hátralevő pályaidő a szerveren: Nincs időkorlát"
"[english]Scoreboard_NoTimeLimit"	"Server map time left: No time limit"
"Scoreboard_ChangeOnRoundEnd"	"(Pályaváltás kör végén...) Hátralevő pályaidő a szerveren: 00:00"
"[english]Scoreboard_ChangeOnRoundEnd"	"(Map change on round end...) Server map time left: 00:00"
"TF_SteamRequired"	"Steam Szükséges"
"[english]TF_SteamRequired"	"Steam Required"
"TF_Nemesis"	"NEMEZIS"
"[english]TF_Nemesis"	"NEMESIS"
"TF_Nemesis_lodef"	"NEM"
"[english]TF_Nemesis_lodef"	"NEM"
"TF_NewNemesis"	"Új Nemezis!"
"[english]TF_NewNemesis"	"New Nemesis!"
"TF_GotRevenge"	"Bosszú!"
"[english]TF_GotRevenge"	"Revenge!"
"TF_FreezeNemesis"	"Nemezis"
"[english]TF_FreezeNemesis"	"Nemesis"
"classinfo_scout"	"A többi osztálynál gyorsabban foglalsz pontokat! A levegőben dupla ugrást hajthatsz végre!"
"[english]classinfo_scout"	"You capture points faster than other classes!
double jump while in the air!"
"classinfo_sniper"	"A mesterlövész puskád fel fog töltődni, hogy több sebzést okozzon, mialatt a zoom-ban vagy. Célozz a fejre kritikus találatokért!"
"[english]classinfo_sniper"	"Your sniper rifle will power up to do more damage while you are zoomed in!
aim for the head to do critical hits!"
"classinfo_soldier"	"Lõdd a rakétát az ellenség lábához! A rakétavetővel rakétaugrani is lehet!"
"[english]classinfo_soldier"	"Shoot your rocket launcher at enemy's feet!
Use your rocket launcher to rocket jump!"
"classinfo_demo"	"Robbantsd fel a tapadóbombákat távvezérléssel, mikor ellenség van a közelükben!
Tapadóbomba-ugráshoz állj rá egyre, és ugorj, miközben felrobbantod!"
"[english]classinfo_demo"	"Remote detonate your stickybombs when enemies are near them!
Stickybomb jump by standing on a stickybomb and jumping as you detonate it!"
"classinfo_medic"	"Töltsd föl az Übercharge-ot a csapattársaid gyógyításával! Használj egy feltöltődött Übercharge-ot, hogy sebezhetetlenné válj a célpontoddal együtt!"
"[english]classinfo_medic"	"Fill your ÜberCharge by healing your team mates!
Use a full ÜberCharge to gain invulnerability for you and your medi gun target!"
"classinfo_heavy"	"Pörgesd a golyószóródat tüzelés nélkül, hogy készen állj az ellenfelek érkezésére!"
"[english]classinfo_heavy"	"Spin your minigun without firing to be ready for approaching enemies!"
"classinfo_pyro"	"A sarkoknál kapd el az ellenséget! A lángszóród annál hatékonyabb, minél közelebb vagy a célponthoz!"
"[english]classinfo_pyro"	"Ambush enemies at corners!
Your flamethrower is more effective the closer you are to your target!"
"classinfo_spy"	"Álcázd magad egyként az ellenség közül, hogy behatolj az ellenséges bázisra! Válj láthatatlanná, hogy elkerüld a lebukást! Szúrd hátba az ellenségeidet a késeddel egy azonnali ölésért! Rakj sapper-eket az ellenséges sentry lövegekre, hogy elpusztítsd azokat!"
"[english]classinfo_spy"	"Disguise yourself as a enemy and infiltrate the enemy base!
cloak yourself to avoid being seen!
Backstab your enemies with your knife for an instant kill!
Plant sappers on enemy sentry guns to destroy them!"
"classinfo_engineer"	"Gyűjts vasat az eldobott fegyverekből, hogy építkezz! Építs sentry gun-okat, hogy megvédd a bázist! Fejleszd őket 3-mas szintig! Építs dispensereket, hogy ellásd a csapattársaidat élettel és lőszerrel! Építs teleportereket, hogy segíts társaidnak eljutni a frontvonalra!"
"[english]classinfo_engineer"	"Collect metal from fallen weapons to build with!
Build sentry guns to defend your base! Upgrade them to level 3!
Build dispensers to supply your teammates with health & ammo!
Build teleporters to help team mates get to the front lines!"
"classinfo_random"	"A játék válasszon osztályt véletlenszerűen."
"[english]classinfo_random"	"Let the game randomly choose a class for you."
"TF_Cancel"	"MÉGSE (&0)"
"[english]TF_Cancel"	"CANCEL (&0)"
"TF_Back"	"&VISSZA"
"[english]TF_Back"	"&BACK"
"TF_WatchIntro"	"&FILM MEGTEKINTÉSE"
"[english]TF_WatchIntro"	"&WATCH MOVIE"
"Button_SkipIntro"	"&FILM ÁTUGRÁSA"
"[english]Button_SkipIntro"	"&SKIP MOVIE"
"TF_Continue"	"&TOVÁBB"
"[english]TF_Continue"	"&CONTINUE"
"TF_SelectAClass"	"KASZT KIVÁLASZTÁSA"
"[english]TF_SelectAClass"	"SELECT A CLASS"
"TF_Play"	"JÁTÉK!"
"[english]TF_Play"	"PLAY!"
"TF_Close"	"&BEZÁRÁS"
"[english]TF_Close"	"&CLOSE"
"TF_NextTip"	"KÖVETKEZŐ &TIPP"
"[english]TF_NextTip"	"NEXT &TIP"
"Button_SkipIntro_360"	"Film átugrása"
"[english]Button_SkipIntro_360"	"Skip Movie"
"Game_connected"	"%s1 csatlakozott"
"[english]Game_connected"	"%s1 connected"
"game_spawn_as"	"* %s1-ként fogsz megszületni"
"[english]game_spawn_as"	"*You will spawn as %s1"
"game_respawn_as"	"* %s1-ként fogsz újraszületni"
"[english]game_respawn_as"	"*You will respawn as %s1"
"game_spawn_asrandom"	"*Véletlenszerű osztállyal fogsz megszületni"
"[english]game_spawn_asrandom"	"*You will spawn as random class"
"game_respawn_asrandom"	"*Véletlenszerű osztállyal fogsz újraszületni"
"[english]game_respawn_asrandom"	"*You will respawn as a random class"
"round_restart_in_sec"	"A kör %s1 másodperc múlva újrakezdődik"
"[english]round_restart_in_sec"	"The round will restart in %s1 second"
"round_restart_in_secs"	"A kör %s1 másodperc múlva újrakezdődik"
"[english]round_restart_in_secs"	"The round will restart in %s1 seconds"
"game_restart_in_sec"	"A játék %s1 másodperc múlva újrakezdődik"
"[english]game_restart_in_sec"	"The game will restart in %s1 second"
"game_restart_in_secs"	"A játék %s1 másodperc múlva újrakezdődik"
"[english]game_restart_in_secs"	"The game will restart in %s1 seconds"
"game_switch_in_sec"	"Csapatváltás!
A játék %s1 másodperc múlva újrakezdődik"
"[english]game_switch_in_sec"	"Switching teams!
The game will restart in %s1 second"
"game_switch_in_secs"	"Csapatváltás!
A játék %s1 másodperc múlva újrakezdődik"
"[english]game_switch_in_secs"	"Switching teams!
The game will restart in %s1 seconds"
"game_scramble_in_sec"	"Csapat-újraosztás!
A játék %s1 másodperc múlva újrakezdődik"
"[english]game_scramble_in_sec"	"Scrambling the teams!
The game will restart in %s1 second"
"game_scramble_in_secs"	"Csapat-újraosztás!
A játék %s1 másodperc múlva újrakezdődik"
"[english]game_scramble_in_secs"	"Scrambling the teams!
The game will restart in %s1 seconds"
"game_respawntime_now"	"Újraszületésre készülj"
"[english]game_respawntime_now"	"Prepare to respawn"
"game_respawntime_in_sec"	"Újraszületésig: 1 másodperc"
"[english]game_respawntime_in_sec"	"Respawn in: 1 second"
"game_respawntime_in_secs"	"Újraszületésig: %s1 másodperc"
"[english]game_respawntime_in_secs"	"Respawn in: %s1 seconds"
"game_respawntime_stalemate"	"Hirtelen Halálkor nincs újraszületés"
"[english]game_respawntime_stalemate"	"No respawning in Sudden Death"
"game_respawntime_next_round"	"Újraszületésig: várj a következő körre"
"[english]game_respawntime_next_round"	"Respawn in: Wait for next round"
"game_auto_team_balance_in"	"A csapatok %s1 másodperc múlva automatikus kiegyenlítésre kerülnek."
"[english]game_auto_team_balance_in"	"Teams will be auto-balanced in %s1 seconds."
"game_player_was_team_balanced"	"%s1 erőkiegyenlítés miatt átkerült a másik csapatba"
"[english]game_player_was_team_balanced"	"%s1 was moved to the other team for game balance"
"game_idle_kick"	"%s1 kirúgásra került, mert túl sokáig volt inaktív"
"[english]game_idle_kick"	"%s1 has been idle for too long and has been kicked"
"DeathMsg_Suicide"	"búcsúzott e kegyetlen világtól!"
"[english]DeathMsg_Suicide"	"bid farewell, cruel world!"
"DeathMsg_AssistedSuicide"	"kivégezte"
"[english]DeathMsg_AssistedSuicide"	"finished off"
"DeathMsg_Fall"	"fájdalmas halálba zuhant"
"[english]DeathMsg_Fall"	"fell to a clumsy, painful death"
"Msg_Captured"	"elfoglalta"
"[english]Msg_Captured"	"captured"
"Msg_Defended"	"megvédte"
"[english]Msg_Defended"	"defended"
"Msg_Dominating"	"ALÁZZA:"
"[english]Msg_Dominating"	"is DOMINATING"
"Msg_Revenge"	"BOSSZÚJA utolérte:"
"[english]Msg_Revenge"	"got REVENGE on"
"Msg_PickedUpFlag"	"felvette az információkat!"
"[english]Msg_PickedUpFlag"	"picked up the intelligence!"
"Msg_CapturedFlag"	"elfogta az információkat!"
"[english]Msg_CapturedFlag"	"captured the intelligence!"
"Msg_DefendedFlag"	"megvédte az információkat!"
"[english]Msg_DefendedFlag"	"defended the intelligence!"
"CP5_red_setup_goal"	"A játék megnyeréséhez foglaljátok el mind az öt ellenőrzőpontot!"
"[english]CP5_red_setup_goal"	"Capture all five of the Control Points to win the game!"
"CP5_blue_setup_goal"	"A játék megnyeréséhez foglaljátok el mind az öt ellenőrzőpontot!"
"[english]CP5_blue_setup_goal"	"Capture all five of the Control Points to win the game!"
"CP_setup_30sec"	"A játék 30 másodperc múlva kezdődik!"
"[english]CP_setup_30sec"	"Game begins in 30 seconds!"
"CP_setup_10sec"	"A játék 10 másodperc múlva kezdődik!"
"[english]CP_setup_10sec"	"Game begins in 10 seconds!"
"CP_cap_cp3"	"a középső ellenőrzőpont"
"[english]CP_cap_cp3"	"the Central Control Point"
"CP_cap_red_cp1"	"a RED bázis"
"[english]CP_cap_red_cp1"	"the RED Base"
"CP_cap_blue_cp1"	"a BLU bázis"
"[english]CP_cap_blue_cp1"	"the BLU Base"
"Dustbowl_red_setup_goal"	"Védd meg az ellenőrzőpontokat a BLU csapat ellen!"
"[english]Dustbowl_red_setup_goal"	"Defend the Control points against team BLU!"
"Dustbowl_blue_setup_goal"	"A kör megnyeréséhez foglald el mindkét ellenőrzőpontot!"
"[english]Dustbowl_blue_setup_goal"	"Capture both Control Points to win the round and advance!"
"Dustbowl_red_final_goal"	"Védd meg az utolsó két ellenőrzőpontot, különben az ellenség nyeri a játékot!"
"[english]Dustbowl_red_final_goal"	"Defend the final two Control Points or the enemy will win the game!"
"Dustbowl_blue_final_goal"	"A játék megnyeréséhez foglald el az utolsó két ellenőrzőpontot!"
"[english]Dustbowl_blue_final_goal"	"Capture the final two Control Points to win the game!"
"Dustbowl_team1"	"Támadók"
"[english]Dustbowl_team1"	"Attackers"
"Dustbowl_team2"	"Védők"
"[english]Dustbowl_team2"	"Defenders"
"Dustbowl_bring_flag"	"Vidd a zászlótokat a
főhadiszállásra!!"
"[english]Dustbowl_bring_flag"	"Bring your flag
to the HQ !!"
"Dustbowl_take_flag_one"	"Vidd a zászlót az
EGYES ellenőrzőponthoz."
"[english]Dustbowl_take_flag_one"	"Take the flag to
Command Point ONE."
"Dustbowl_take_flag_two"	"Vidd a zászlót a
KETTES ellenőrzőponthoz."
"[english]Dustbowl_take_flag_two"	"Take the flag to
Command Point TWO."
"Dustbowl_blue_secures_one"	"A BLU csapat elfoglalja az
EGYES ellenőrzőpontot !!"
"[english]Dustbowl_blue_secures_one"	"Team BLU Secures
Command Point ONE !!"
"Dustbowl_blue_secures_two"	"A BLU csapat elfoglalja a
KETTES ellenőrzőpontot !!"
"[english]Dustbowl_blue_secures_two"	"Team BLU Secures
Command Point TWO !!"
"Dustbowl_flag_returned"	"A zászló visszakerült a bázisra."
"[english]Dustbowl_flag_returned"	"Flag has returned to base."
"Dustbowl_90_secs"	"90 másodperc a kapunyitásig."
"[english]Dustbowl_90_secs"	"90 seconds till gates open."
"Dustbowl_60_secs"	"60 másodperc a kapunyitásig."
"[english]Dustbowl_60_secs"	"60 seconds till gates open."
"Dustbowl_30_secs"	"30 másodperc a kapunyitásig."
"[english]Dustbowl_30_secs"	"30 seconds till gates open."
"Dustbowl_10_secs"	"10 másodperc a kapunyitásig."
"[english]Dustbowl_10_secs"	"10 seconds till gates open."
"Dustbowl_five_minutes_left"	"Hátralevő idő:
Öt perc"
"[english]Dustbowl_five_minutes_left"	"Time remaining:
Five minutes"
"Dustbowl_four_minutes_left"	"Hátralevő idő:
Négy perc"
"[english]Dustbowl_four_minutes_left"	"Time remaining:
Four minutes"
"Dustbowl_three_minutes_left"	"Hátralevő idő:
Három perc"
"[english]Dustbowl_three_minutes_left"	"Time remaining:
Three minutes"
"Dustbowl_two_minutes_left"	"Hátralevő idő:
Két perc"
"[english]Dustbowl_two_minutes_left"	"Time remaining:
Two minutes"
"Dustbowl_sixty_seconds_left"	"Hátralevő idő:
Hatvan másodperc"
"[english]Dustbowl_sixty_seconds_left"	"Time remaining:
Sixty seconds"
"Dustbowl_thirty_seconds_left"	"Hátralevő idő:
Harminc másodperc"
"[english]Dustbowl_thirty_seconds_left"	"Time remaining:
Thirty seconds"
"Dustbowl_attackers_win"	"A főhadiszállást
elfoglalták !!"
"[english]Dustbowl_attackers_win"	"The Headquarters has
been captured !!"
"Dustbowl_cap_1_A"	"az Első foglalás első szakaszát"
"[english]Dustbowl_cap_1_A"	"First Cap, Stage One"
"Dustbowl_cap_1_B"	"a Második foglalás első szakaszát"
"[english]Dustbowl_cap_1_B"	"Second Cap, Stage One"
"Dustbowl_cap_2_A"	"az Első foglalás második szakaszát"
"[english]Dustbowl_cap_2_A"	"First Cap, Stage Two"
"Dustbowl_cap_2_B"	"a Második foglalás második szakaszát"
"[english]Dustbowl_cap_2_B"	"Second Cap, Stage Two"
"Dustbowl_cap_3_A"	"az Első foglalás harmadik szakaszát"
"[english]Dustbowl_cap_3_A"	"First Cap, Stage Three"
"Dustbowl_cap_3_B"	"a Rakétát, az utolsó foglalást"
"[english]Dustbowl_cap_3_B"	"the Rocket, Final Cap"
"Goldrush_red_setup_goal"	"Akadályozd meg, hogy az ellenséges csapat a bázisodra vigye a kocsit!"
"[english]Goldrush_red_setup_goal"	"Prevent the enemy team from moving the cart to your base!"
"Goldrush_blue_setup_goal"	"A kör megnyeréséhez és a továbbjutáshoz vidd a kocsit az ellenőrzőpontokhoz!"
"[english]Goldrush_blue_setup_goal"	"Move the cart to the Control Points to win the round and advance!"
"Goldrush_red_final_goal"	"Akadályozd meg, hogy a kocsi a bázisodra érjen, különben az ellenség nyeri a játékot!"
"[english]Goldrush_red_final_goal"	"Prevent the cart from moving to your base or the enemy will win the game!"
"Goldrush_blue_final_goal"	"Az ellenséges bázis megsemmisítéséhez és a játék megnyeréséhez vidd oda a kocsit!"
"[english]Goldrush_blue_final_goal"	"Move the cart to the enemy base to destroy it and win the game!"
"Goldrush_team1"	"Támadók"
"[english]Goldrush_team1"	"Attackers"
"Goldrush_team2"	"Védők"
"[english]Goldrush_team2"	"Defenders"
"Goldrush_cap_1_A"	"Első foglalás, első szakasz"
"[english]Goldrush_cap_1_A"	"First Cap, Stage One"
"Goldrush_cap_1_B"	"Második foglalás, első szakasz"
"[english]Goldrush_cap_1_B"	"Second Cap, Stage One"
"Goldrush_cap_2_A"	"Első foglalás, második szakasz"
"[english]Goldrush_cap_2_A"	"First Cap, Stage Two"
"Goldrush_cap_2_B"	"Második foglalás, második szakasz"
"[english]Goldrush_cap_2_B"	"Second Cap, Stage Two"
"Goldrush_cap_3_A"	"Első foglalás, harmadik szakasz"
"[english]Goldrush_cap_3_A"	"First Cap, Stage Three"
"Goldrush_cap_3_B"	"Második foglalás, harmadik szakasz"
"[english]Goldrush_cap_3_B"	"Second Cap, Stage Three"
"Goldrush_cap_3_C"	"Atomgödör, utolsó foglalás"
"[english]Goldrush_cap_3_C"	"Atomic pit, Final Cap"
"Badwater_cap_1"	"Első foglalási pont"
"[english]Badwater_cap_1"	"First Capture point"
"Badwater_cap_2"	"Második foglalási pont"
"[english]Badwater_cap_2"	"Second Capture point"
"Badwater_cap_3"	"Harmadik foglalási pont"
"[english]Badwater_cap_3"	"Third Capture point"
"Badwater_cap_4"	"Utolsó foglalási pont"
"[english]Badwater_cap_4"	"Final Capture point"
"2fort_red_setup_goal"	"Szerezd meg az információs táskát az ellenség pincéjéből. A győzelemhez menj vissza a saját pincédbe!"
"[english]2fort_red_setup_goal"	"Grab the Intelligence Briefcase from the enemy basement. Return to your basement to win!"
"2fort_blue_setup_goal"	"Szerezd meg az információs táskát az ellenség pincéjéből. A győzelemhez menj vissza a saját pincédbe!"
"[english]2fort_blue_setup_goal"	"Grab the Intelligence Briefcase from the enemy basement. Return to your basement to win!"
"Granary_red_setup_goal"	"A játék megnyeréséhez foglaljátok el mind az öt ellenőrzőpontot!"
"[english]Granary_red_setup_goal"	"Capture all five Control Points to win the game!"
"Granary_blue_setup_goal"	"A játék megnyeréséhez foglaljátok el mind az öt ellenőrzőpontot!"
"[english]Granary_blue_setup_goal"	"Capture all five Control Points to win the game!"
"Granary_cap_cp3"	"a középső ellenőrzőpont"
"[english]Granary_cap_cp3"	"the Central Control Point"
"Granary_cap_red_cp2"	"a RED raktár"
"[english]Granary_cap_red_cp2"	"the RED Warehouse"
"Granary_cap_red_cp1"	"a RED bázis"
"[english]Granary_cap_red_cp1"	"the RED Base"
"Granary_cap_blue_cp2"	"a BLU raktár"
"[english]Granary_cap_blue_cp2"	"the BLU Warehouse"
"Granary_cap_blue_cp1"	"a BLU bázis"
"[english]Granary_cap_blue_cp1"	"the BLU Base"
"Gravelpit_red_setup_goal"	"A játék megnyeréséhez védd meg mindhárom ellenőrzőpontot a BLU csapat ellen!"
"[english]Gravelpit_red_setup_goal"	"Defend all three Control Points against team BLU to win the game!"
"Gravelpit_blue_setup_goal"	"A győzelemhez foglald el mindhárom ellenőrzőpontot; előbb az A-t és a B-t, majd végül a C-t!"
"[english]Gravelpit_blue_setup_goal"	"Capture all three Controls Points to win! First capture A and B, then move on to C."
"Gravelpit_cap_A"	"A-t, a rádiótornyot"
"[english]Gravelpit_cap_A"	"cap A, the Radio Tower"
"Gravelpit_cap_B"	"B-t, a radart"
"[english]Gravelpit_cap_B"	"cap B, the Radar"
"Gravelpit_cap_C"	"C-t, a lézerágyút"
"[english]Gravelpit_cap_C"	"cap C, the Laser Gun"
"Hydro_red_setup_goal"	"A kör megnyeréséhez foglald el a BLU-k egyetlen ellenőrzőpontját! Ne hagyd, hogy ők ugyanezt tegyék!"
"[english]Hydro_red_setup_goal"	"Capture BLU's single Control Point to win the round. Prevent them from doing the same!"
"Hydro_blue_setup_goal"	"A kör megnyeréséhez foglald el a RED-ek egyetlen ellenőrzőpontját! Ne hagyd, hogy ők ugyanezt tegyék!"
"[english]Hydro_blue_setup_goal"	"Capture RED's single Control Point to win the round. Prevent them from doing the same!"
"Hydro_red_base_attack"	"A játék megnyeréséhez foglald el a BLU csapat utolsó ellenőrzőpontját!"
"[english]Hydro_red_base_attack"	"Capture team BLU's final Control Point to win the game!"
"Hydro_red_base_defend"	"Védd meg az utolsó ellenőrzőpontot a BLU-k ellen, vagy ők nyerik a játékot!"
"[english]Hydro_red_base_defend"	"Defend your final Control Point against BLU or they will win!"
"Hydro_blue_base_attack"	"A játék megnyeréséhez foglald el a RED csapat utolsó ellenőrzőpontját!"
"[english]Hydro_blue_base_attack"	"Capture team RED's final Control Point to win the game!"
"Hydro_blue_base_defend"	"Védd meg az utolsó ellenőrzőpontot a RED-ek ellen, vagy ők nyerik a játékot!"
"[english]Hydro_blue_base_defend"	"Defend your final Control Point against RED or they will win!"
"Hydro_cap_red_base"	"a RED bázis"
"[english]Hydro_cap_red_base"	"the RED Base"
"Hydro_cap_blue_base"	"a BLU bázis"
"[english]Hydro_cap_blue_base"	"the BLU Base"
"Hydro_cap_radar_dish"	"a radar"
"[english]Hydro_cap_radar_dish"	"the Radar Dish"
"Hydro_cap_dam"	"a gát"
"[english]Hydro_cap_dam"	"the Dam"
"Hydro_cap_power_plant"	"az erőmű"
"[english]Hydro_cap_power_plant"	"the Power Plant"
"Hydro_cap_warehouse"	"a raktár"
"[english]Hydro_cap_warehouse"	"the Warehouse"
"Pipeline_setup_goal"	"A menet megnyeréséhez ti vigyétek előbb a kocsit a foglalási ponthoz!"
"[english]Pipeline_setup_goal"	"Move your cart to the capture point first to win this heat!"
"Pipeline_cap_1_red"	"A RED első foglalási pontja"
"[english]Pipeline_cap_1_red"	"Red's first Capture point"
"Pipeline_cap_1_blue"	"A BLU első foglalási pontja"
"[english]Pipeline_cap_1_blue"	"Blue's first Capture point"
"Pipeline_cap_2_red"	"A RED második foglalási pontja"
"[english]Pipeline_cap_2_red"	"Red's second Capture point"
"Pipeline_cap_2_blue"	"A BLU második foglalási pontja"
"[english]Pipeline_cap_2_blue"	"Blue's second Capture point"
"Pipeline_cap_3_red"	"A RED utolsó foglalási pontja"
"[english]Pipeline_cap_3_red"	"Red's final capture point"
"Pipeline_cap_3_blue"	"A BLU utolsó foglalási pontja"
"[english]Pipeline_cap_3_blue"	"Blue's final capture point"
"Badlands_cap_cp3"	"a középső ellenőrzőpont"
"[english]Badlands_cap_cp3"	"the Central Control Point"
"Badlands_cap_red_cp2"	"a RED torony"
"[english]Badlands_cap_red_cp2"	"the RED Spire"
"Badlands_cap_red_cp1"	"a RED bázis"
"[english]Badlands_cap_red_cp1"	"the RED Base"
"Badlands_cap_blue_cp2"	"a BLU torony"
"[english]Badlands_cap_blue_cp2"	"the BLU Spire"
"Badlands_cap_blue_cp1"	"a BLU bázis"
"[english]Badlands_cap_blue_cp1"	"the BLU Base"
"koth_setup_goal"	"A játék megnyeréséhez foglaljátok el és védjétek meg az ellenőrzőpontot!"
"[english]koth_setup_goal"	"Capture and hold the Control Point to win the game!"
"koth_viaduct_cap"	"az ellenőrzőpont"
"[english]koth_viaduct_cap"	"the Control Point"
"Arena_cap"	"az ellenőrzőpont"
"[english]Arena_cap"	"the Control Point"
"Cant_cap_stealthed"	"Láthatatlanul nem
 lehet foglalni."
"[english]Cant_cap_stealthed"	"Cannot capture point
    while stealthed."
"Cant_cap_disguised"	"Álruhában nem
 lehet foglalni."
"[english]Cant_cap_disguised"	"Cannot capture point
    while disguised."
"Cant_cap_invuln"	"Sérthetetlenül nem
 lehet foglalni."
"[english]Cant_cap_invuln"	"Cannot capture point
  while invulnerable."
"Cant_cap_stunned"	"Kábultan nem
lehet foglalni."
"[english]Cant_cap_stunned"	"Cannot capture point
    while stunned."
"FreezePanel_NoKiller"	"Meghaltál"
"[english]FreezePanel_NoKiller"	"You were killed"
"FreezePanel_Killer"	"Megölt"
"[english]FreezePanel_Killer"	"You were killed by"
"FreezePanel_Killer_Dead"	"Megölt a néhai"
"[english]FreezePanel_Killer_Dead"	"You were killed by the late"
"FreezePanel_Nemesis"	"Megint megölt"
"[english]FreezePanel_Nemesis"	"You were killed again by"
"FreezePanel_Nemesis_Dead"	"Megint megölt a néhai"
"[english]FreezePanel_Nemesis_Dead"	"You were killed again by the late"
"FreezePanel_KillerObject"	"Megölt a %objectkiller% ami tőle jött:"
"[english]FreezePanel_KillerObject"	"You were killed by the %objectkiller% of"
"FreezePanel_KillerObject_Dead"	"Megölt a %objectkiller% ami tőle jött, aki meghalt:"
"[english]FreezePanel_KillerObject_Dead"	"You were killed by the %objectkiller% of the late"
"FreezePanel_KillerHealth"	"Maradék egészség: %s1"
"[english]FreezePanel_KillerHealth"	"Health left: %s1"
"FreezePanel_Callout"	"Egy darabka te!"
"[english]FreezePanel_Callout"	"A bit of you!"
"FreezePanel_Callout2"	"Még egy darab!"
"[english]FreezePanel_Callout2"	"Another bit!"
"FreezePanel_Callout3"	"További darabok!"
"[english]FreezePanel_Callout3"	"More bits!"
"FreezePanel_Item"	"%killername% fegyvere:"
"[english]FreezePanel_Item"	"%killername% is carrying:"
"Callout_Ragdoll"	"Te!"
"[english]Callout_Ragdoll"	"You!"
"Callout_Head"	"A fejed!"
"[english]Callout_Head"	"Your head!"
"Callout_Foot"	"A lábad!"
"[english]Callout_Foot"	"Your foot!"
"Callout_Hand"	"A kezed!"
"[english]Callout_Hand"	"Your hand!"
"Callout_Torso"	"A törzsed!"
"[english]Callout_Torso"	"Your torso!"
"Callout_Organ1"	"A léped!"
"[english]Callout_Organ1"	"Your spleen!"
"Callout_Organ2"	"A tüdőd!"
"[english]Callout_Organ2"	"Your lungs!"
"Callout_Organ3"	"A májad!"
"[english]Callout_Organ3"	"Your liver!"
"Callout_Organ4"	"A hasnyálmirigyed!"
"[english]Callout_Organ4"	"Your pancreas!"
"Callout_Organ5"	"A veséd!"
"[english]Callout_Organ5"	"Your kidney!"
"Callout_Organ6"	"A vakbeled!"
"[english]Callout_Organ6"	"Your appendix!"
"ControlPointIconCappers"	"x%numcappers%"
"[english]ControlPointIconCappers"	"x%numcappers%"
"game_WaitingForPlayers"	"Várakozás játékosokra"
"[english]game_WaitingForPlayers"	"Waiting For Players"
"game_Overtime"	"Hosszabbítás"
"[english]game_Overtime"	"Overtime"
"EnterStalemate"	"Hirtelen halál mód!
Nincs újraszületés!"
"[english]EnterStalemate"	"Sudden Death Mode!
No more respawning!"
"game_SuddenDeath"	"Hirtelen halál"
"[english]game_SuddenDeath"	"Sudden Death"
"game_stalemate_cant_change_class"	"Eltelt %s1 másodperc.
Hirtelen halál módban most már nem válthatsz osztályt!"
"[english]game_stalemate_cant_change_class"	"%s1 seconds have passed.
You can't change class in Sudden Death Mode now!"
"Gametype_CTF"	"Zászlóelfogás"
"[english]Gametype_CTF"	"Capture the Flag"
"Gametype_CP"	"Ellenőrzőpontok"
"[english]Gametype_CP"	"Control Points"
"Gametype_Escort"	"Szállítmány"
"[english]Gametype_Escort"	"Payload"
"Gametype_Arena"	"Aréna"
"[english]Gametype_Arena"	"Arena"
"Gametype_EscortRace"	"Szállítmányverseny"
"[english]Gametype_EscortRace"	"Payload Race"
"Intro_Title"	"Játékmód bemutatása: %gamemode%"
"[english]Intro_Title"	"Game Mode Introduction:   %gamemode%"
"Intro_CaptureIntro"	"Üdvözlünk az Ellenőrzőpontok játékmód bemutatóján."
"[english]Intro_CaptureIntro"	"Welcome to the Capture Point game mode introduction."
"Intro_capturepoints"	"A csapatodnak a győzelemhez öt ellenőrzőpontot kell birtokolnia.
A HUD mutatja, melyik ellenőrzőpont melyik csapat birtokában van."
"[english]Intro_capturepoints"	"Your team must own 5 Capture Points to win.
The HUD shows which team owns each capture point."
"Intro_fakecapture"	"Az ellenőrzőpont elfoglalásához állj a közelébe.
A HUD mutatja az elfoglalás előrehaladását."
"[english]Intro_fakecapture"	"Stand near the Capture Point to capture it.
The HUD shows your capture progress."
"Intro_multcapture"	"Több csapattag gyorsabban foglal el egy pontot!
Segíts a csapatodnak!"
"[english]Intro_multcapture"	"Multiple team members capture points faster!
Help your team out!"
"Intro_yourpoint"	"Ne hagyd, hogy az ellenség elfoglalja az utolsó pontotokat!
Védd meg, vagy veszítetek!"
"[english]Intro_yourpoint"	"Don't let the enemy capture your last point!
Defend it or you lose!"
"Intro_ctf_intro"	"Játékmód bemutatása: mindkét csapatnak meg kell szereznie az ellenség titkos aktáit, és közben megvédeni a sajátjaikat."
"[english]Intro_ctf_intro"	"Game Mode Introduction: Each team must capture the enemy's secret files, while defending their own."
"Intro_ctf_red_assault_base"	"A titkos akták ellopásához támadd meg az ellenség bázisát."
"[english]Intro_ctf_red_assault_base"	"Assault the enemy base to steal their secret files."
"Intro_ctf_red_steal_files"	"Lopd el az aktatáskát az ellenséges bázis pincéjéből."
"[english]Intro_ctf_red_steal_files"	"Steal the briefcase from the basement of the enemy base."
"Intro_ctf_red_return_and_cap"	"A pontszerzéshez tedd a táskát a csapatod pincéjében levő asztalra."
"[english]Intro_ctf_red_return_and_cap"	"Return the briefcase to the desk in your team's basement to capture it and score."
"Intro_ctf_red_defend"	"Ne felejts el segíteni a csapatod táskájának megvédésében!"
"[english]Intro_ctf_red_defend"	"Don't forget to help defend your team's briefcase from the enemy!"
"Intro_ctf_blue_assault_base"	"A titkos akták ellopásához támadd meg az ellenség bázisát."
"[english]Intro_ctf_blue_assault_base"	"Assault the enemy base to steal their secret files."
"Intro_ctf_blue_steal_files"	"Lopd el az aktatáskát az ellenség bázisának pincéjéből."
"[english]Intro_ctf_blue_steal_files"	"Steal the briefcase from the basement of the enemy base."
"Intro_ctf_blue_return_and_cap"	"A pontszerzéshez tedd a táskát a csapatod pincéjében levő asztalra."
"[english]Intro_ctf_blue_return_and_cap"	"Return the briefcase to the desk in your team's basement to capture it and score."
"Intro_ctf_blue_defend"	"Ne felejts el segíteni a csapatod táskájának megvédésében!"
"[english]Intro_ctf_blue_defend"	"Don't forget to help defend your team's briefcase from the enemy!"
"Intro_attack_defense_intro"	"Ez egy támadó-védekező pálya, 
a BLU-k megpróbálnak területet foglalni, a RED-ek pedig megakadályozni ezt."
"[english]Intro_attack_defense_intro"	"This is an attack defense map,  
BLU tries to capture areas while RED tries to stop them."
"Intro_attack_defense_capping"	"Ellenőrzőpont elfoglalásához a BLU-knak a közelébe kell állni.
A HUD mutatja az elfoglalás előrehaladását."
"[english]Intro_attack_defense_capping"	"BLU must stand near the Capture Point to capture it.
The HUD shows your capture progress."
"Intro_attack_defense_cap_a"	"A BLU-knak el kell foglalni mind az A..."
"[english]Intro_attack_defense_cap_a"	"BLU must capture both Capture point A ..."
"Intro_attack_defense_cap_final"	"Miután a BLU-k elfoglalták mind az A, mind a B pontot, elérhetővé válik az utolsó ellenőrzőpont."
"[english]Intro_attack_defense_cap_final"	"After BLU owns capture point A and capture point B the final Capture point unlocks"
"Intro_attack_defense_cap_timer"	"A BLU-k ideje minden elfoglalt ponttal három percet nő. A RED-ek nem tudnak visszafoglalni egy pontot, ha a BLU-k már elfoglalták."
"[english]Intro_attack_defense_cap_timer"	"BLU earns 3 minutes on the timer for each succesful captured point. RED cannot capture points back once BLU own them."
"Hint_spotted_a_friend"	"Csapattársat láttál!"
"[english]Hint_spotted_a_friend"	"You have spotted a teammate!"
"Hint_spotted_an_enemy"	"Ellenséget láttál!"
"[english]Hint_spotted_an_enemy"	"You have spotted an enemy!"
"Hint_killing_enemies_is_good"	"Megöltél egy ellenséget!"
"[english]Hint_killing_enemies_is_good"	"You killed an enemy!"
"Hint_out_of_ammo"	"Elfogyott a lőszered!"
"[english]Hint_out_of_ammo"	"Your weapon is out of ammo!"
"Hint_turn_off_hints"	"A tippeket kikapcsolhatod a Beállítások menüben;
 Beállítások -> Többjátékos -> Haladó -> 'Automata segítség'"
"[english]Hint_turn_off_hints"	"You can turn off hints in the options menu,
 under Options -> Multiplayer -> Advanced -> 'Auto Help'"
"Hint_pickup_ammo"	"Vegyél fel lőszert az elejtett fegyverekből!"
"[english]Hint_pickup_ammo"	"Pick up ammo from fallen weapons!"
"Hint_Cannot_Teleport_With_Flag"	"Nem teleportálhatsz, mikor nálad van az aktatáska."
"[english]Hint_Cannot_Teleport_With_Flag"	"You cannot teleport when you have the briefcase."
"Hint_Cannot_Cloak_With_Flag"	"Nem válhatsz láthatatlanná, mikor nálad van az aktatáska."
"[english]Hint_Cannot_Cloak_With_Flag"	"You cannot cloak when you have the briefcase."
"Hint_Cannot_Disguise_With_Flag"	"Nem használhatsz álruhát, mikor nálad van az aktatáska."
"[english]Hint_Cannot_Disguise_With_Flag"	"You cannot disguise when you have the briefcase."
"Hint_Cannot_Attack_While_Cloaked"	"Láthatatlanul nem támadhatsz."
"[english]Hint_Cannot_Attack_While_Cloaked"	"You cannot attack while cloaked."
"Hint_Cannot_Invuln_With_Flag"	"Nem válhatsz sérthetetlenné, mikor nálad van az aktatáska."
"[english]Hint_Cannot_Invuln_With_Flag"	"You cannot go invulnerable when you have the briefcase."
"Hint_Cannot_Attack_While_Feign_Armed"	"Nem támadhatsz előkészített színlelt halálnál."
"[english]Hint_Cannot_Attack_While_Feign_Armed"	"You cannot attack while feign death is armed."
"Hint_Cannot_Arm_Feign_Now"	"Halál színleléséhez teljesen teli álcamérő szükséges."
"[english]Hint_Cannot_Arm_Feign_Now"	"You need a full cloak meter to arm feign death."
"Hint_ClassMenu"	"Osztályváltáshoz nyomd meg a(z) '%changeclass%'-t."
"[english]Hint_ClassMenu"	"Press '%changeclass%' to change your player class."
"Hint_altfire_sniperrifle"	"A(z) '%attack2%' megnyomásával használhatod a távcsövet a mesterlövész-puskán."
"[english]Hint_altfire_sniperrifle"	"You can hit '%attack2%' to zoom with your sniper rifle."
"Hint_altfire_grenadelauncher"	"A(z) '%attack2%' megnyomásával akkor is felrobbanthatod a tapadóbombákat, ha épp a gránátvetőt használod."
"[english]Hint_altfire_grenadelauncher"	"You can hit '%attack2%' to detonate stickybombs even while using your grenade launcher."
"Hint_altfire_pipebomblauncher"	"A(z) '%attack2%' megnyomásával felrobbanthatod a tapadóbomba-vetővel kilőtt tapadóbombákat."
"[english]Hint_altfire_pipebomblauncher"	"You can hit '%attack2%' to detonate stickybombs launched with your stickybomb launcher."
"Hint_altfire_rotate_building"	"A(z) '%attack2%' megnyomásával lerakás előtt forgathatod az építményeket."
"[english]Hint_altfire_rotate_building"	"You can hit '%attack2%' to rotate buildings before you place them."
"Hint_Soldier_rpg_reload"	"A rakétavető újratöltéséhez nyomd meg a(z) '%reload%'-t.
Mindig tölts újra, mikor épp nem harcolsz!"
"[english]Hint_Soldier_rpg_reload"	"Hit '%reload%' to reload your rocket launcher.
Reload it whenever you're out of combat!"
"Hint_Engineer_use_wrench_onown"	"Ütögesd az épülő tárgyakat a franciakulccsal,
hogy gyorsabban készüljenek el!"
"[english]Hint_Engineer_use_wrench_onown"	"Hit constructing objects with your wrench
to make them build faster!"
"Hint_Engineer_use_wrench_onother"	"Ütögesd csapattársaid épülő tárgyait a franciakulccsal,
hogy segíts nekik gyorsabban építeni!"
"[english]Hint_Engineer_use_wrench_onother"	"Hit your teammate's constructing objects with your wrench
to help them build faster!"
"Hint_Engineer_build_sentrygun"	"Építs őrtornyokat a csapatod bázisának védelmére.
A fegyverválasztó negyedik helyén az építhető dolgok vannak."
"[english]Hint_Engineer_build_sentrygun"	"Build sentry guns to defend your team's base.
The fourth slot in your weapon selection holds buildables."
"Hint_Engineer_build_dispenser"	"Építs adagolókat, hogy segíts a csapattagoknak újratöltekezni.
A fegyverválasztó negyedik helyén az építhető dolgok vannak."
"[english]Hint_Engineer_build_dispenser"	"Build Dispensers to help your teammates to resupply.
The fourth slot in your weapon selection holds buildables."
"Hint_Engineer_build_teleporters"	"Építs teleportokat, hogy segíts a csapatodnak védeni az előretolt állásokat.
A fegyverválasztó negyedik helyén az építhető dolgok vannak."
"[english]Hint_Engineer_build_teleporters"	"Build Teleporters to help your team defend forward areas.
The fourth slot in your weapon selection holds buildables."
"Hint_Engineer_pickup_metal"	"Szedj össze fémet az elejtett fegyverekből,
amit építéshez használhatsz!"
"[english]Hint_Engineer_pickup_metal"	"Pick up metal from fallen weapons
to use in building objects!"
"Hint_Engineer_repair_object"	"A sérült építmények megjavításához ütögesd azokat a franciakulccsal!"
"[english]Hint_Engineer_repair_object"	"Hit damaged objects with your wrench to repair them!"
"Hint_Engineer_metal_to_upgrade"	"Az őrtornyod továbbfejlesztéséhez több fémre van szükség!"
"[english]Hint_Engineer_metal_to_upgrade"	"You need more metal to upgrade your sentry gun!"
"Hint_Engineer_upgrade_sentrygun"	"Az őrtornyok továbbfejlesztéséhez ütögesd azokat a franciakulccsal.
Egészen 3. szintig lehet fejleszteni őket!"
"[english]Hint_Engineer_upgrade_sentrygun"	"Upgrade sentry guns by hitting them with your wrench.
They can be upgraded all the way to level 3!"
"Hint_object_has_sapper"	"Ezt az építményt egy mentesítő rongálja!
Lőj a mentesítőre, hogy elpusztítsd azt!"
"[english]Hint_object_has_sapper"	"This building is being destroyed by a sapper!
 Shoot the sapper to destroy it!"
"Hint_object_your_object_sapped"	"Az egyik építményed rongálódik!"
"[english]Hint_object_your_object_sapped"	"One of your buildings is being destroyed!"
"Hint_enemy_using_dispenser"	"Ellenség használja az adagolódat!"
"[english]Hint_enemy_using_dispenser"	"An enemy is using your dispenser!"
"Hint_enemy_using_tp_entrance"	"Ellenség van a teleport-bejáratod közelében!"
"[english]Hint_enemy_using_tp_entrance"	"An enemy is near your teleporter entrance!"
"Hint_enemy_using_tp_exit"	"Ellenség van a teleport-kijáratod közelében!"
"[english]Hint_enemy_using_tp_exit"	"An enemy is near your teleporter exit!"
"StatPanel_Format_Close"	"Ez a kör: %s1  Legjobb eredményed: %s2"
"[english]StatPanel_Format_Close"	"That round: %s1  Your best: %s2"
"StatPanel_Healing_Best"	"Ebben a körben %s1-ként többet gyógyítottál, mint a korábbi legjobb eredményed."
"[english]StatPanel_Healing_Best"	"You healed more as %s1 that round than your previous best."
"StatPanel_Invulnerable_Best"	"Ebben a körben többet voltál sebezhetetlen, mint a korábbi legjobb eredményed."
"[english]StatPanel_Invulnerable_Best"	"You went invulnerable more that round than your previous best."
"StatPanel_Backstabs_Best"	"Ebben a körben több hátbadöfést csináltál, mint a korábbi legjobb eredményed."
"[english]StatPanel_Backstabs_Best"	"You had more backstabs that round than your previous best."
"StatPanel_BuildingsBuilt_Best"	"Ebben a körben több építményt készítettél, mint a korábbi legjobb eredményed."
"[english]StatPanel_BuildingsBuilt_Best"	"You built more buildings that round than your previous best."
"StatPanel_BuildingsDestroyed_Best"	"Ebben a körben %s1-ként több építményt tettél tönkre, mint a korábbi legjobb eredményed."
"[english]StatPanel_BuildingsDestroyed_Best"	"You destroyed more buildings that round as %s1 than your previous best."
"StatPanel_Headshots_Best"	"Ebben a körben több fejlövést csináltál, mint a korábbi legjobb eredményed."
"[english]StatPanel_Headshots_Best"	"You had more headshots that round than your previous best."
"StatPanel_Healing_Tie"	"Ebben a körben %s1-ként ugyanannyit gyógyítottál, mint a rekordod."
"[english]StatPanel_Healing_Tie"	"You tied your record for healing as %s1 that round."
"StatPanel_Backstabs_Tie"	"Ebben a körben ugyanannyi hátbadöfést csináltál, mint a rekordod."
"[english]StatPanel_Backstabs_Tie"	"You tied your record for backstabs that round."
"StatPanel_HealthLeached_Tie"	"Ebben a körben ugyanannyi egészséget loptál az ellenségtől, mint a rekordod."
"[english]StatPanel_HealthLeached_Tie"	"You tied your record for health stolen from the enemy that round."
"StatPanel_BuildingsBuilt_Tie"	"Ebben a körben ugyanannyi építményt készítettél, mint a rekordod."
"[english]StatPanel_BuildingsBuilt_Tie"	"You tied your record for buildings built that round."
"StatPanel_BuildingsDestroyed_Tie"	"Ebben a körben %s1-ként ugyanannyi építményt tettél tönkre, mint a rekordod."
"[english]StatPanel_BuildingsDestroyed_Tie"	"You tied your record for buildings destroyed as %s1 that round."
"StatPanel_Headshots_Tie"	"Ebben a körben ugyanannyi fejlövést csináltál, mint a rekordod."
"[english]StatPanel_Headshots_Tie"	"You tied your record for headshots that round."
"StatPanel_Healing_Close"	"Ebben a körben %s1-ként majdnem annyit gyógyítottál, mint a rekordod."
"[english]StatPanel_Healing_Close"	"You came close to your record for healing as %s1 that round."
"StatPanel_Backstabs_Close"	"Ebben a körben majdnem annyi hátbadöfést csináltál, mint a rekordod."
"[english]StatPanel_Backstabs_Close"	"You came close to your record for backstabs that round."
"StatPanel_HealthLeached_Close"	"Ebben a körben majdnem annyi egészséget loptál az ellenségtől, mint a rekordod."
"[english]StatPanel_HealthLeached_Close"	"You came close to your record for health stolen from the enemy that round."
"StatPanel_BuildingsBuilt_Close"	"Ebben a körben majdnem annyi építményt készítettél, mint a rekordod."
"[english]StatPanel_BuildingsBuilt_Close"	"You came close to your record for buildings built that round."
"StatPanel_BuildingsDestroyed_Close"	"Ebben a körben %s1-ként majdnem annyi építményt tettél tönkre, mint a rekordod."
"[english]StatPanel_BuildingsDestroyed_Close"	"You came close to your record for buildings destroyed as %s1 that round."
"StatPanel_Headshots_Close"	"Ebben a körben majdnem annyi fejlövést csináltál, mint a rekordod."
"[english]StatPanel_Headshots_Close"	"You came close to your record for headshots that round."
"Tip_1_Count"	"16"
"[english]Tip_1_Count"	"16"
"Tip_2_Count"	"13"
"[english]Tip_2_Count"	"13"
"Tip_3_Count"	"17"
"[english]Tip_3_Count"	"17"
"Tip_4_Count"	"18"
"[english]Tip_4_Count"	"18"
"Tip_5_Count"	"22"
"[english]Tip_5_Count"	"22"
"Tip_6_Count"	"13"
"[english]Tip_6_Count"	"13"
"Tip_7_Count"	"21"
"[english]Tip_7_Count"	"21"
"Tip_8_Count"	"30"
"[english]Tip_8_Count"	"30"
"Tip_9_Count"	"17"
"[english]Tip_9_Count"	"17"
"Building_hud_building"	"Épül..."
"[english]Building_hud_building"	"Building..."
"Building_hud_sentry_shells"	"Lőszer:"
"[english]Building_hud_sentry_shells"	"Shells:"
"Building_hud_sentry_rockets"	"Rakéta:"
"[english]Building_hud_sentry_rockets"	"Rockets:"
"Building_hud_sentry_upgrade"	"Fejlesztés:"
"[english]Building_hud_sentry_upgrade"	"Upgrade:"
"Building_hud_sentry_numkills"	"Ölés: %numkills%"
"[english]Building_hud_sentry_numkills"	"Kills: %numkills%"
"Building_hud_dispenser_ammo"	"Fém:"
"[english]Building_hud_dispenser_ammo"	"Metal:"
"Building_hud_tele_charging"	"Töltődik..."
"[english]Building_hud_tele_charging"	"Charging..."
"Building_hud_tele_times_used"	"Használva:
%timesused%"
"[english]Building_hud_tele_times_used"	"Times Used:
%timesused%"
"Building_hud_tele_times_used_360"	"Használva:
%timesused%"
"[english]Building_hud_tele_times_used_360"	"Used:
%timesused%"
"Building_hud_sentry_not_built"	"Őrtorony
Nincs építve"
"[english]Building_hud_sentry_not_built"	"Sentry Gun
Not Built"
"Building_hud_dispenser_not_built"	"Adagoló
Nincs építve"
"[english]Building_hud_dispenser_not_built"	"Dispenser
Not Built"
"Building_hud_tele_enter_not_built"	"Bejárat
Nincs építve"
"[english]Building_hud_tele_enter_not_built"	"Entrance
Not Built"
"Building_hud_sentry_not_built_360"	"Őrtorony
Nincs építve"
"[english]Building_hud_sentry_not_built_360"	"Sentry
Not Built"
"Building_hud_tele_enter_not_built_360"	"Bejárat
Nincs építve"
"[english]Building_hud_tele_enter_not_built_360"	"Entrance
Not Built"
"Building_hud_tele_exit_not_built_360"	"Kijárat
Nincs építve"
"[english]Building_hud_tele_exit_not_built_360"	"Exit
Not Built"
"Hud_Menu_Demolish_Title"	"Lebont"
"[english]Hud_Menu_Demolish_Title"	"Demolish"
"Hud_Menu_Build_Title"	"Épít"
"[english]Hud_Menu_Build_Title"	"Build"
"Hud_Menu_Disguise_Title"	"Álcáz"
"[english]Hud_Menu_Disguise_Title"	"Disguise"
"Hud_Menu_Build_Cant_Afford"	"Nincs elég
fém"
"[english]Hud_Menu_Build_Cant_Afford"	"Not Enough
Metal"
"Hud_Menu_Build_Already_Built"	"Már van építve"
"[english]Hud_Menu_Build_Already_Built"	"Already Built"
"Hud_Menu_Build_Cancel"	"Nyomd meg a '%lastinv%' gombot a visszavonáshoz"
"[english]Hud_Menu_Build_Cancel"	"Hit '%lastinv%' to Cancel"
"Hud_Menu_Spy_Minus_Toggle"	"Nyomd meg a '%disguiseteam%' gombot a csapatcseréhez"
"[english]Hud_Menu_Spy_Minus_Toggle"	"Hit '%disguiseteam%' to Toggle Team"
"Hud_Menu_Spy_Toggle"	"Csapatcsere"
"[english]Hud_Menu_Spy_Toggle"	"Toggle Teams"
"Hud_Menu_Spy_Select_Disguise"	"Álruha-választás"
"[english]Hud_Menu_Spy_Select_Disguise"	"Select Disguise"
"Hud_Menu_Build_Action_Demolish"	"Lebont"
"[english]Hud_Menu_Build_Action_Demolish"	"Demolish"
"Hud_Menu_Build_Action_Build"	"Épít"
"[english]Hud_Menu_Build_Action_Build"	"Build"
"Cancel"	"Mégse"
"[english]Cancel"	"Cancel"
"LoadingMap"	"Ide tartasz:"
"[english]LoadingMap"	"You're on your way to:"
"round_info_header"	"Területfoglalásos pálya"
"[english]round_info_header"	"Territorial Control Map"
"Hydro_BLU_captured_Dam"	"A BLU-k elfoglalták a gátat"
"[english]Hydro_BLU_captured_Dam"	"BLU has captured the Dam"
"Hydro_BLU_captured_RadarDish"	"A BLU-k elfoglalták a radart"
"[english]Hydro_BLU_captured_RadarDish"	"BLU has captured the Radar Dish"
"Hydro_BLU_captured_PowerPlant"	"A BLU-k elfoglalták az erőművet"
"[english]Hydro_BLU_captured_PowerPlant"	"BLU has captured the Power Plant"
"Hydro_BLU_captured_Warehouse"	"A BLU-k elfoglalták a raktárt"
"[english]Hydro_BLU_captured_Warehouse"	"BLU has captured the Warehouse"
"Hydro_RED_captured_Dam"	"A RED-ek elfoglalták a gátat"
"[english]Hydro_RED_captured_Dam"	"RED has captured the Dam"
"Hydro_RED_captured_RadarDish"	"A RED-ek elfoglalták a radart"
"[english]Hydro_RED_captured_RadarDish"	"RED has captured the Radar Dish"
"Hydro_RED_captured_PowerPlant"	"A RED-ek elfoglalták az erőművet"
"[english]Hydro_RED_captured_PowerPlant"	"RED has captured the Power Plant"
"Hydro_RED_captured_Warehouse"	"A RED-ek elfoglalták a raktárt"
"[english]Hydro_RED_captured_Warehouse"	"RED has captured the Warehouse"
"Hydro_attack_Dam"	"Felkészülni a gát támadására!"
"[english]Hydro_attack_Dam"	"Prepare to attack the Dam!"
"Hydro_attack_RadarDish"	"Felkészülni a radar támadására!"
"[english]Hydro_attack_RadarDish"	"Prepare to attack the Radar Dish!"
"Hydro_attack_PowerPlant"	"Felkészülni az erőmű támadására!"
"[english]Hydro_attack_PowerPlant"	"Prepare to attack the Power Plant!"
"Hydro_attack_Warehouse"	"Felkészülni a raktár támadására!"
"[english]Hydro_attack_Warehouse"	"Prepare to attack the Warehouse!"
"Hydro_attack_BLU_base"	"Felkészülni a BLU bázis támadására!"
"[english]Hydro_attack_BLU_base"	"Prepare to attack the BLU Base!"
"Hydro_attack_RED_base"	"Felkészülni a RED bázis támadására!"
"[english]Hydro_attack_RED_base"	"Prepare to attack the RED Base!"
"Hydro_defend_BLU_base"	"Felkészülni a BLU bázis védelmére!"
"[english]Hydro_defend_BLU_base"	"Prepare to defend the BLU Base!"
"Hydro_defend_RED_base"	"Felkészülni a RED bázis védelmére!"
"[english]Hydro_defend_RED_base"	"Prepare to defend the RED Base!"
"Leaderboard_BestMoments"	"LEGJOBB PILLANATOK"
"[english]Leaderboard_BestMoments"	"BEST MOMENTS"
"Cannot_Be_Spectator"	"Ez a szerver nem engedélyezi a néző-módot"
"[english]Cannot_Be_Spectator"	"This server does not allow spectating"
"Item"	"Tárgy"
"[english]Item"	"Item"
"SelectedItemNumber"	"#%selecteditem%"
"[english]SelectedItemNumber"	"#%selecteditem%"
"NewItemsAcquired"	"%numitems% ÚJ TÁRGY MEGSZEREZVE!"
"[english]NewItemsAcquired"	"%numitems% NEW ITEMS ACQUIRED!"
"NewItemAcquired"	"ÚJ TÁRGY MEGSZEREZVE!"
"[english]NewItemAcquired"	"NEW ITEM ACQUIRED!"
"NewItemsCrafted"	"%numitems% ÚJ TÁRGY ELKÉSZÍTVE!"
"[english]NewItemsCrafted"	"%numitems% NEW ITEMS CRAFTED!"
"NewItemCrafted"	"ÚJ TÁRGY ELKÉSZÍTVE!"
"[english]NewItemCrafted"	"NEW ITEM CRAFTED!"
"NextItem"	"KÖVETKEZŐ
MEGTEKINTÉSE >"
"[english]NextItem"	"VIEW
NEXT >"
"PreviousItem"	"ELŐZŐ
< MEGTEKINTÉSE"
"[english]PreviousItem"	"VIEW
< PREV"
"CloseItemPanel"	"OK, JÁTÉK FOLYTATÁSA"
"[english]CloseItemPanel"	"OK, RESUME GAME"
"ChangeLoadout"	"TÁRGY HASZNÁLATA MOST..."
"[english]ChangeLoadout"	"EQUIP THIS ITEM NOW..."
"CharInfoAndSetup"	"KARAKTER INFO ÉS BEÁLLÍTÁS"
"[english]CharInfoAndSetup"	"CHARACTER INFO AND SETUP"
"Loadout"	"FELSZERELÉS"
"[english]Loadout"	"LOADOUT"
"Achievements"	"TELJESÍTMÉNYEK"
"[english]Achievements"	"ACHIEVEMENTS"
"CharacterLoadout"	"KARAKTER FELSZERELÉSE"
"[english]CharacterLoadout"	"CHARACTER LOADOUT"
"EditLoadout"	"FELSZERELÉS SZERKESZTÉSE"
"[english]EditLoadout"	"EDIT LOADOUT"
"SelectClassLoadout"	"FELSZERELÉS MÓDOSÍTÁSÁHOZ VÁLASSZ OSZTÁLYT"
"[english]SelectClassLoadout"	"SELECT A CLASS TO MODIFY LOADOUT"
"NoSteamNoItems"	"A FELSZERELÉS NEM ELÉRHETŐ - NINCS STEAM-KAPCSOLAT"
"[english]NoSteamNoItems"	"LOADOUT NOT AVAILABLE - COULD NOT CONNECT TO STEAM"
"LoadoutChangesUpdate"	"MEGJEGYZÉS: A FELSZERELÉS VÁLTOZÁSA ÚJJÁSZÜLETÉSKOR LÉP ÉRVÉNYBE."
"[english]LoadoutChangesUpdate"	"NOTE: LOADOUT CHANGES WILL TAKE EFFECT ON RESPAWN."
"EquipYourClass"	"%loadoutclass% FELSZERELÉSE"
"[english]EquipYourClass"	"EQUIP YOUR %loadoutclass%"
"Equip"	"FELSZEREL"
"[english]Equip"	"EQUIP"
"Keep"	"MEGTART"
"[english]Keep"	"KEEP"
"ClassBeingEquipped"	"%loadoutclass%"
"[english]ClassBeingEquipped"	"%loadoutclass%"
"ChangeButton"	"VÁLTOZTAT..."
"[english]ChangeButton"	"CHANGE..."
"DoneButton"	"KÉSZ!"
"[english]DoneButton"	"DONE!"
"EquipSelectedWeapon"	"VÁLASZTOTT FEGYVER HASZNÁLATA"
"[english]EquipSelectedWeapon"	"EQUIP SELECTED WEAPON"
"ItemSel_PRIMARY"	"- ELSŐDLEGES FEGYVER"
"[english]ItemSel_PRIMARY"	"- PRIMARY WEAPON"
"ItemSel_SECONDARY"	"- MÁSODLAGOS FEGYVER"
"[english]ItemSel_SECONDARY"	"- SECONDARY WEAPON"
"ItemSel_MELEE"	"- KÖZELHARC-FEGYVER"
"[english]ItemSel_MELEE"	"- MELEE WEAPON"
"ItemSel_PDA"	"- PDA"
"[english]ItemSel_PDA"	"- PDA"
"ItemSel_ITEM1"	"- KIEGÉSZÍTŐ"
"[english]ItemSel_ITEM1"	"- ACCESSORY"
"ItemSel_HEAD"	"- FEJREVALÓ"
"[english]ItemSel_HEAD"	"- HEADWEAR"
"ItemSel_MISC"	"- EGYÉB"
"[english]ItemSel_MISC"	"- MISC"
"InventoryCountOne"	"(1 TOVÁBBI A LELTÁRBAN)"
"[english]InventoryCountOne"	"(1 OTHER IN INVENTORY)"
"InventoryCountMany"	"(%s1 TOVÁBBI A LELTÁRBAN)"
"[english]InventoryCountMany"	"(%s1 OTHERS IN INVENTORY)"
"CurrentlyEquipped"	"JELENLEG HASZNÁLATBAN:"
"[english]CurrentlyEquipped"	"CURRENTLY EQUIPPED:"
"CurrentlyEquippedCarat"	"JELENLEG HASZNÁLATBAN >"
"[english]CurrentlyEquippedCarat"	"CURRENTLY EQUIPPED >"
"ItemsFoundShort"	"(%s1 TÁRGY A LELTÁRBAN)"
"[english]ItemsFoundShort"	"(%s1 ITEMS IN INVENTORY)"
"ItemsFoundShortOne"	"(EGY TÁRGY A LELTÁRBAN)"
"[english]ItemsFoundShortOne"	"(ONE ITEM IN INVENTORY)"
"NoItemsExistShort"	"(MÉG NEM LÉTEZNEK TÁRGYAK)"
"[english]NoItemsExistShort"	"(NO ITEMS EXIST YET)"
"NoItemsExistLong"	"(A %loadoutclass% SZÁMÁRA MÉG NEM LÉTEZIK SAJÁT TÁRGY.)"
"[english]NoItemsExistLong"	"(NO SPECIAL ITEMS FOR %loadoutclass% EXIST YET.)"
"NoItemsFoundLong"	"(A %loadoutclass% MÉG NEM SZERZETT SPECIÁLIS TÁRGYAT.)"
"[english]NoItemsFoundLong"	"(NO SPECIAL ITEMS FOR %loadoutclass% HAVE BEEN ACQUIRED YET.)"
"NoItemsAvailableTitle"	"ELÉRHETŐ:"
"[english]NoItemsAvailableTitle"	"AVAILABLE:"
"NoItemsAvailableTitle2"	"CSAK ALAPKÉSZLET."
"[english]NoItemsAvailableTitle2"	"BASE INVENTORY ONLY."
"ItemAcquireReason_Achievement"	"TELJESÍTMÉNNYEL SZEREZVE"
"[english]ItemAcquireReason_Achievement"	"ACHIEVEMENT EARNED"
"NoItemsToEquip"	"NINCS IDE VALÓ TÁRGYAD"
"[english]NoItemsToEquip"	"YOU HAVE NO ITEMS FOR THIS LOADOUT SLOT"
"QuickSwitchEquipped"	"(használatban)"
"[english]QuickSwitchEquipped"	"(equipped)"
"SelectNoItemSlot"	"Üres"
"[english]SelectNoItemSlot"	"Empty"
"BackpackTitle"	"HÁTIZSÁK"
"[english]BackpackTitle"	"BACKPACK"
"DeleteConfirmTitle"	"BIZTOS?"
"[english]DeleteConfirmTitle"	"ARE YOU SURE?"
"DeleteItemConfirmText"	"A tárgy törléskor végérvényesen megsemmisül. A művelet nem visszavonható."
"[english]DeleteItemConfirmText"	"Deleting this item will permanently destroy it. This cannot be undone."
"MultiDeleteItemConfirmText"	"A tárgyak törléskor végérvényesen megsemmisülnek. A művelet nem visszavonható."
"[english]MultiDeleteItemConfirmText"	"Deleting these items will permanently destroy all of them. This cannot be undone."
"Backpack_Delete_Item"	"HÁTIZSÁK - NINCS TÖBB HELY"
"[english]Backpack_Delete_Item"	"BACKPACK - OUT OF ROOM"
"DiscardExplanation"	"Megkaptad ezt a tárgyat, de nincs hely számára a hátizsákodban."
"[english]DiscardExplanation"	"You've received this item, but you don't have room for it in your backpack."
"DiscardExplanation2"	"Törölj egy tárgyat az alábbiak közül, hogy helyet csinálj neki, vagy nyomd meg az eldobást az új tárgy eldobásához."
"[english]DiscardExplanation2"	"Delete an item below to make room or press discard to throw your new item away."
"DeleteConfirmDefault"	"Törölhető?"
"[english]DeleteConfirmDefault"	"Delete?"
"Discarded"	"ELDOBVA!"
"[english]Discarded"	"DISCARDED!"
"ItemPanelEquipped"	"Használatban"
"[english]ItemPanelEquipped"	"Equipped"
"LoadoutSlot_Primary"	"Elsődleges fegyver"
"[english]LoadoutSlot_Primary"	"Primary weapon"
"LoadoutSlot_Secondary"	"Másodlagos fegyver"
"[english]LoadoutSlot_Secondary"	"Secondary weapon"
"LoadoutSlot_Melee"	"Közelharc-fegyver"
"[english]LoadoutSlot_Melee"	"Melee weapon"
"LoadoutSlot_Grenade"	"Gránát"
"[english]LoadoutSlot_Grenade"	"Grenade"
"LoadoutSlot_Building"	"Épület"
"[english]LoadoutSlot_Building"	"Building"
"LoadoutSlot_pda"	"Elsődleges PDA"
"[english]LoadoutSlot_pda"	"Primary PDA"
"LoadoutSlot_pda2"	"Másodlagos PDA"
"[english]LoadoutSlot_pda2"	"Secondary PDA"
"LoadoutSlot_PrimaryMod"	"Lőszer"
"[english]LoadoutSlot_PrimaryMod"	"Ammo"
"LoadoutSlot_Head"	"Fej"
"[english]LoadoutSlot_Head"	"Head"
"LoadoutSlot_Misc"	"Egyéb"
"[english]LoadoutSlot_Misc"	"Misc"
"Backpack_SortBy_Header"	"Hátizsák rendezése"
"[english]Backpack_SortBy_Header"	"Sort Backpack"
"Backpack_SortBy_Type"	"Rendezés típus szerint"
"[english]Backpack_SortBy_Type"	"Sort by Type"
"Backpack_SortBy_Class"	"Rendezés osztály szerint"
"[english]Backpack_SortBy_Class"	"Sort by Class"
"Backpack_SortBy_Slot"	"Rendezés felszerelés-pozíció szerint"
"[english]Backpack_SortBy_Slot"	"Sort by Loadout Slot"
"ItemTypeDesc"	"%s1. szintű %s2"
"[english]ItemTypeDesc"	"Level %s1 %s2"
"of"	"/"
"[english]of"	"of"
"CraftRecipe"	"Ismert tervrajzok"
"[english]CraftRecipe"	"Known Blueprints"
"CraftStep1"	"Válaszd ki a készítendő tárgyat"
"[english]CraftStep1"	"Select items to craft"
"CraftStep2"	"Kattints duplán a tárgyakra, vagy húzd át ide őket"
"[english]CraftStep2"	"Double-click or drag items here"
"CraftStep3B"	"Válaszd ki a használandó tervrajzot."
"[english]CraftStep3B"	"Select the blueprint you want to use."
"CraftViewRecipes"	"Minden ismert tervrajz megtekintése"
"[english]CraftViewRecipes"	"View all known blueprints"
"CraftNoMatch"	"Nincs megfelelő tervrajz"
"[english]CraftNoMatch"	"No matching blueprint"
"CraftNoknownRecipes"	"Nem ismersz tervrajzokat."
"[english]CraftNoknownRecipes"	"No blueprints known."
"NewRecipeFound"	"Új tervrajzot találtál!"
"[english]NewRecipeFound"	"New Blueprint Found!"
"RDI_AB"	"Szükséges: %s1 %s2"
"[english]RDI_AB"	"Requires: %s1 %s2"
"RDI_ABC"	"Szükséges: %s1 %s2 %s3"
"[english]RDI_ABC"	"Requires: %s1 %s2 %s3"
"RDO_AB"	"Eredményez: %s1 %s2"
"[english]RDO_AB"	"Produces: %s1 %s2"
"RDO_ABC"	"Eredményez: %s1 %s2 %s3"
"[english]RDO_ABC"	"Produces: %s1 %s2 %s3"
"RI_Pi"	"ugyanabból az elsődleges fegyverből"
"[english]RI_Pi"	"of the same primary weapon"
"RI_Pp"	"elsődleges fegyverek"
"[english]RI_Pp"	"primary weapons"
"RI_P"	"elsődleges fegyver"
"[english]RI_P"	"primary weapon"
"RI_Ic"	"ugyanazon osztály által használt tárgyak"
"[english]RI_Ic"	"items used by the same class"
"RI_Wc"	"ugyanazon osztály által használt fegyverek"
"[english]RI_Wc"	"weapons used by the same class"
"RI_Is"	"ugyanarra a felszerelés-helyre való tárgyak"
"[english]RI_Is"	"items equipped in the same loadout slot"
"RI_Ws"	"ugyanarra a felszerelés-helyre való fegyverek"
"[english]RI_Ws"	"weapons equipped in the same loadout slot"
"RI_Si"	"ugyanabból a másodlagos fegyverből"
"[english]RI_Si"	"of the same secondary weapon"
"RI_Sp"	"másodlagos fegyverek"
"[english]RI_Sp"	"secondary weapons"
"RI_S"	"másodlagos fegyver"
"[english]RI_S"	"secondary weapon"
"RI_Mi"	"ugyanabból a közelharc-fegyverből"
"[english]RI_Mi"	"of the same melee weapon"
"RI_Mp"	"közelharc-fegyverek"
"[english]RI_Mp"	"melee weapons"
"RI_M"	"közelharc-fegyver"
"[english]RI_M"	"melee weapon"
"RI_Hi"	"ugyanabból a fejfedőből"
"[english]RI_Hi"	"of the same piece of headwear"
"RI_Hp"	"fejfedők"
"[english]RI_Hp"	"pieces of headwear"
"RI_H"	"fejfedő"
"[english]RI_H"	"piece of headwear"
"RD_RND"	"véletlenszerű"
"[english]RD_RND"	"random"
"RI_Cw"	"osztály fegyverei"
"[english]RI_Cw"	"class weapons"
"RI_Ch"	"osztály fejfedői"
"[english]RI_Ch"	"class headgear"
"RI_Aw"	"elsődleges, másodlagos és közelharc-fegyver"
"[english]RI_Aw"	"primary, secondary, and melee weapon"
"RI_Hg"	"fejfedő"
"[english]RI_Hg"	"headgear"
"RI_Cs"	"osztály-specifikus"
"[english]RI_Cs"	"class specific"
"RI_CTc"	", 1 osztály-token"
"[english]RI_CTc"	", 1 Class Token"
"RI_STc"	", 1 hely-token"
"[english]RI_STc"	", 1 Slot Token"
"RI_W"	"fegyver"
"[english]RI_W"	"weapon"
"RI_Mcp"	"egyéb tárgy"
"[english]RI_Mcp"	"miscellaneous items"
"RI_Mci"	"ugyanolyan egyéb tárgyakból"
"[english]RI_Mci"	"of the same misc items"
"RI_STp"	"Hely-tokenek"
"[english]RI_STp"	"Slot Tokens"
"RI_Tp"	"Tokenek"
"[english]RI_Tp"	"Tokens"
"CI_Bar_A"	"Hulladékfém"
"[english]CI_Bar_A"	"Scrap Metal"
"CI_Bar_B"	"Kinyert fém"
"[english]CI_Bar_B"	"Reclaimed Metal"
"CI_Bar_C"	"Finomított fém"
"[english]CI_Bar_C"	"Refined Metal"
"CI_Bar_Ap"	"Hulladékfém"
"[english]CI_Bar_Ap"	"Scrap Metal"
"CI_Bar_Bp"	"Kinyert fém"
"[english]CI_Bar_Bp"	"Reclaimed Metal"
"CI_Bar_Cp"	"Finomított fém"
"[english]CI_Bar_Cp"	"Refined Metal"
"CI_T_C"	"Osztály-token"
"[english]CI_T_C"	"Class Token"
"CI_T_S"	"Hely-token"
"[english]CI_T_S"	"Slot Token"
"CI_T_S_1"	"Hely-token - Elsődleges"
"[english]CI_T_S_1"	"Slot Token - Primary"
"CI_T_S_2"	"Hely-token - Másodlagos"
"[english]CI_T_S_2"	"Slot Token - Secondary"
"CI_T_S_3"	"Hely-token - Közelharc"
"[english]CI_T_S_3"	"Slot Token - Melee"
"CI_T_S_4"	"Hely-token - Gránát"
"[english]CI_T_S_4"	"Slot Token - Grenade"
"CI_T_S_5"	"Hely-token - Építmény"
"[english]CI_T_S_5"	"Slot Token - Building"
"CI_T_S_6"	"Hely-token - PDA"
"[english]CI_T_S_6"	"Slot Token - PDA"
"CI_T_S_7"	"Hely-token - PDA2"
"[english]CI_T_S_7"	"Slot Token - PDA2"
"CI_T_S_8"	"Hely-token - Fej"
"[english]CI_T_S_8"	"Slot Token - Head"
"Attrib_ClipSize_Positive"	"+%s1% tárméret"
"[english]Attrib_ClipSize_Positive"	"+%s1% clip size"
"Attrib_ClipSize_Negative"	"%s1% tárméret"
"[english]Attrib_ClipSize_Negative"	"%s1% clip size"
"Attrib_DamageDone_Positive"	"+%s1% okozott sebzés"
"[english]Attrib_DamageDone_Positive"	"+%s1% damage done"
"Attrib_DamageDone_Negative"	"%s1% okozott sebzés"
"[english]Attrib_DamageDone_Negative"	"%s1% damage done"
"Attrib_HealRate_Positive"	"+%s1% gyógyítási sebesség"
"[english]Attrib_HealRate_Positive"	"+%s1% heal rate"
"Attrib_HealRate_Negative"	"%s1% gyógyítási sebesség"
"[english]Attrib_HealRate_Negative"	"%s1% heal rate"
"Attrib_FireRate_Positive"	"+%s1% magasabb tűzgyorsaság"
"[english]Attrib_FireRate_Positive"	"+%s1% faster firing speed"
"Attrib_FireRate_Negative"	"%s1% alacsonyabb tűzgyorsaság"
"[english]Attrib_FireRate_Negative"	"%s1% slower firing speed"
"Attrib_HealOnHit_Positive"	"Találatkor: +%s1 egészség"
"[english]Attrib_HealOnHit_Positive"	"On Hit: +%s1 health"
"Attrib_HealOnHit_Negative"	"Találatkor: %s1 egészség"
"[english]Attrib_HealOnHit_Negative"	"On Hit: %s1 health"
"Attrib_CritChance_Positive"	"+%s1 esély kritikus találatra"
"[english]Attrib_CritChance_Positive"	"+%s1 critical hit chance"
"Attrib_CritChance_Negative"	"%s1 esély kritikus találatra"
"[english]Attrib_CritChance_Negative"	"%s1 critical hit chance"
"Attrib_CritChance_Disabled"	"Nincs véletlenszerű kritikus találat"
"[english]Attrib_CritChance_Disabled"	"No random critical hits"
"Attrib_DamageDoneBonus_Positive"	"Találatkor: +%s1% sebzésbónusz"
"[english]Attrib_DamageDoneBonus_Positive"	"On Hit: +%s1% damage bonus"
"Attrib_CritVsBurning"	"100% kritikus találat égő játékosokon"
"[english]Attrib_CritVsBurning"	"100% critical hit vs burning players"
"Attrib_DmgPenaltyVsNonBurning"	"%s1% sebzés nem égő játékosokon"
"[english]Attrib_DmgPenaltyVsNonBurning"	"%s1% damage vs non-burning players"
"Attrib_NoCritVsNonBurning"	"Nincs kritikus találat nem égő játékosokon"
"[english]Attrib_NoCritVsNonBurning"	"No critical hits vs non-burning players"
"Attrib_ModFlamethrowerPush"	"Nincs sűrített levegő"
"[english]Attrib_ModFlamethrowerPush"	"No compression blast"
"Attrib_ModFlamethrower_BackCrits"	"100% kritikus találat hátulról"
"[english]Attrib_ModFlamethrower_BackCrits"	"100% critical hits from behind"
"Attrib_MaxHealth_Positive"	"+%s1 maximális egészség a viselőnek"
"[english]Attrib_MaxHealth_Positive"	"+%s1 max health on wearer"
"Attrib_MaxHealth_Negative"	"%s1 maximális egészség a viselőnek"
"[english]Attrib_MaxHealth_Negative"	"%s1 max health on wearer"
"Attrib_FistsHaveRadialBuff"	"Öléskor: +50 egészség a közeli csapattársaknak
Öléskor: +10% kritikus találati esély a közeli csapattársaknak"
"[english]Attrib_FistsHaveRadialBuff"	"On Kill: +50 health on nearby teammates
On Kill: +10% Crit Chance on nearby teammates"
"Attrib_CritBoost_OnKill"	"Öléskor: %s1 másodpercig 100% kritikus találat"
"[english]Attrib_CritBoost_OnKill"	"On Kill: %s1 seconds of 100% critical chance"
"Attrib_Slow_Enemy_OnHit"	"Találatkor: %s1% esély a célpont lassítására"
"[english]Attrib_Slow_Enemy_OnHit"	"On Hit: %s1% chance to slow target"
"Attrib_CloakMeterConsumeRate"	"+%s1% láthatatlanság-fogyási sebesség"
"[english]Attrib_CloakMeterConsumeRate"	"+%s1% cloak drain rate"
"Attrib_CloakMeterRegenRate"	"+%s1% láthatatlanság-töltődési sebesség"
"[english]Attrib_CloakMeterRegenRate"	"+%s1% cloak regen rate"
"Attrib_Spread_Negative"	"%s1% kisebb pontosság"
"[english]Attrib_Spread_Negative"	"%s1% less accurate"
"Attrib_Spread_Positive"	"%s1% nagyobb pontosság"
"[english]Attrib_Spread_Positive"	"%s1% more accurate"
"Attrib_BatLaunchesBalls"	"Ez az ütő erős kábító labdát lő ki"
"[english]Attrib_BatLaunchesBalls"	"This bat knocks out a mean stun ball"
"Attrib_DmgPenaltyVsNonStunned"	"%s1% sebzés elkábítatlan játékosokon"
"[english]Attrib_DmgPenaltyVsNonStunned"	"%s1% damage vs non-stunned players"
"Attrib_ZoomSpeedMod_Disabled"	"Nincs sebességcsökkentés távcső használatakor"
"[english]Attrib_ZoomSpeedMod_Disabled"	"No move speed penalty from zoom"
"Attrib_SniperCharge_Per_Sec"	"+%s1% töltődési sebesség"
"[english]Attrib_SniperCharge_Per_Sec"	"+%s1% charge rate"
"Attrib_SniperNoHeadshots"	"Nincs fejlövés"
"[english]Attrib_SniperNoHeadshots"	"No headshots"
"Attrib_Scattergun_HasKnockback"	"Visszalöki a célpontot és a lövészt"
"[english]Attrib_Scattergun_HasKnockback"	"Knockback on the target and shooter"
"Attrib_BulletsPerShot_Bonus"	"+%s1% lövedék lövésenként"
"[english]Attrib_BulletsPerShot_Bonus"	"+%s1% bullets per shot"
"Attrib_SniperNoCharge"	"Nincs ráközelítés és sebzésnövelés"
"[english]Attrib_SniperNoCharge"	"No zoom or damage charge"
"Attrib_CloakIsFeignDeath"	"Álcatípus: Tettetett halál"
"[english]Attrib_CloakIsFeignDeath"	"Cloak Type: Feign Death"
"Attrib_CloakIsMovementBased"	"Álcatípus: Mozgásérzékenység"
"[english]Attrib_CloakIsMovementBased"	"Cloak Type: Motion Sensitive"
"Attrib_NoDoubleJump"	"A viselő nem tud duplaugrást végezni"
"[english]Attrib_NoDoubleJump"	"Disables double jump on wearer"
"Attrib_AbsorbDmgWhileCloaked"	"Láthatatlan állapotban elnyel %s1% sebzést"
"[english]Attrib_AbsorbDmgWhileCloaked"	"Absorbs %s1% damage while cloaked"
"Attrib_RevolverUseHitLocations"	"A pontos fejlövés kritikus sebzést okoz"
"[english]Attrib_RevolverUseHitLocations"	"Crits on an accurate headshot"
"Attrib_MoveSpeed_Penalty"	"%s1% lassabb mozgás viseléskor"
"[english]Attrib_MoveSpeed_Penalty"	"%s1% slower move speed on wearer"
"Attrib_Jarate_Description"	"Mini kritikus találatok a beterített ellenfélen
Tűzoltáshoz is jól jön"
"[english]Attrib_Jarate_Description"	"Coated enemies take mini-crits
Also handy for putting out a fire"
"Attrib_HealthRegen"	"+%s1 másodpercenkénti egészség-regenerálás viseléskor"
"[english]Attrib_HealthRegen"	"+%s1 health regenerated per second on wearer"
"Attrib_DmgTaken_From_Fire_Reduced"	"+%s1% tűzzel szembeni ellenállás viseléskor"
"[english]Attrib_DmgTaken_From_Fire_Reduced"	"+%s1% fire damage resistance on wearer"
"Attrib_DmgTaken_From_Fire_Increased"	"%s1% tűzzel szembeni sebezhetőség viseléskor"
"[english]Attrib_DmgTaken_From_Fire_Increased"	"%s1% fire damage vulnerability on wearer"
"Attrib_DmgTaken_From_Crit_Reduced"	"+%s1% kritikus találattal szembeni ellenállás viseléskor"
"[english]Attrib_DmgTaken_From_Crit_Reduced"	"+%s1% critical hit damage resistance on wearer"
"Attrib_DmgTaken_From_Crit_Increased"	"%s1% kritikus találattal szembeni sebezhetőség viseléskor"
"[english]Attrib_DmgTaken_From_Crit_Increased"	"%s1% critical hit damage vulnerability on wearer"
"Attrib_DmgTaken_From_Blast_Reduced"	"+%s1% robbanással szembeni ellenállás viseléskor"
"[english]Attrib_DmgTaken_From_Blast_Reduced"	"+%s1% explosive damage resistance on wearer"
"Attrib_DmgTaken_From_Blast_Increased"	"%s1% robbanással szembeni sebezhetőség viseléskor"
"[english]Attrib_DmgTaken_From_Blast_Increased"	"%s1% explosive damage vulnerability on wearer"
"Attrib_DmgTaken_From_Bullets_Reduced"	"+%s1% lövedékekkel szembeni ellenállóság viseléskor"
"[english]Attrib_DmgTaken_From_Bullets_Reduced"	"+%s1% bullet damage resistance on wearer"
"Attrib_DmgTaken_From_Bullets_Increased"	"%s1% lövedékekkel szembeni sebezhetőség viseléskor"
"[english]Attrib_DmgTaken_From_Bullets_Increased"	"%s1% bullet damage vulnerability on wearer"
"Attrib_CaptureValue_Increased"	"+%s1 foglalási sebesség viseléskor"
"[english]Attrib_CaptureValue_Increased"	"+%s1 capture rate on wearer"
"Attrib_HealthFromHealers_Reduced"	"%s1% egészség a gyógyítótól viseléskor"
"[english]Attrib_HealthFromHealers_Reduced"	"%s1% health from healers on wearer"
"Attrib_HealthFromHealers_Increased"	"+%s1% egészség a gyógyítótól viseléskor"
"[english]Attrib_HealthFromHealers_Increased"	"+%s1% health from healers on wearer"
"Attrib_WpnBurnDmg_Increased"	"+%s1% tűzsebzés"
"[english]Attrib_WpnBurnDmg_Increased"	"+%s1% burn damage"
"Attrib_WpnBurnDmg_Reduced"	"%s1% tűzsebzés"
"[english]Attrib_WpnBurnDmg_Reduced"	"%s1% burn damage"
"Attrib_WpnBurnTime_Increased"	"+%s1% égési idő"
"[english]Attrib_WpnBurnTime_Increased"	"+%s1% burn duration"
"Attrib_WpnBurnTime_Reduced"	"%s1% égési idő"
"[english]Attrib_WpnBurnTime_Reduced"	"%s1% burn duration"
"Attrib_MaxammoPrimary_Increased"	"+%s1% maximális elsődleges lőszer viseléskor"
"[english]Attrib_MaxammoPrimary_Increased"	"+%s1% max primary ammo on wearer"
"Attrib_MaxammoPrimary_Reduced"	"%s1% maximális elsődleges lőszer viseléskor"
"[english]Attrib_MaxammoPrimary_Reduced"	"%s1% max primary ammo on wearer"
"Attrib_MaxammoSecondary_Increased"	"+%s1% maximális másodlagos lőszer viseléskor"
"[english]Attrib_MaxammoSecondary_Increased"	"+%s1% max secondary ammo on wearer"
"Attrib_MaxammoSecondary_Reduced"	"%s1% maximális másodlagos lőszer viseléskor"
"[english]Attrib_MaxammoSecondary_Reduced"	"%s1% max secondary ammo on wearer"
"Attrib_MaxammoMetal_Increased"	"+%s1% maximális fém viseléskor"
"[english]Attrib_MaxammoMetal_Increased"	"+%s1% max metal on wearer"
"Attrib_MaxammoMetal_Reduced"	"%s1% maximális fém viseléskor"
"[english]Attrib_MaxammoMetal_Reduced"	"%s1% max metal on wearer"
"Attrib_CloakConsumeRate_Increased"	"-%s1% láthatatlansági idő"
"[english]Attrib_CloakConsumeRate_Increased"	"-%s1% cloak duration"
"Attrib_CloakConsumeRate_Decreased"	"+%s1% láthatatlansági idő"
"[english]Attrib_CloakConsumeRate_Decreased"	"+%s1% cloak duration"
"Attrib_CloakRegenRate_Increased"	"+%s1% láthatatlanság-újratöltési sebesség"
"[english]Attrib_CloakRegenRate_Increased"	"+%s1% cloak regeneration rate"
"Attrib_CloakRegenRate_Decreased"	"%s1% láthatatlanság-újratöltési sebesség"
"[english]Attrib_CloakRegenRate_Decreased"	"%s1% cloak regeneration rate"
"Attrib_MinigunSpinup_Increased"	"%s1% hosszabb felpörgési idő"
"[english]Attrib_MinigunSpinup_Increased"	"%s1% slower spin up time"
"Attrib_MinigunSpinup_Decreased"	"%s1% rövidebb felpörgési idő"
"[english]Attrib_MinigunSpinup_Decreased"	"%s1% faster spin up time"
"Attrib_MaxPipebombs_Increased"	"+%s1 maximális telepített csőbomba"
"[english]Attrib_MaxPipebombs_Increased"	"+%s1 max pipebombs out"
"Attrib_MaxPipebombs_Decreased"	"%s1 maximális telepített csőbomba"
"[english]Attrib_MaxPipebombs_Decreased"	"%s1 max pipebombs out"
"Attrib_SRifleChargeRate_Increased"	"%s1% gyorsabb töltődés"
"[english]Attrib_SRifleChargeRate_Increased"	"%s1% faster power charge"
"Attrib_SRifleChargeRate_Decreased"	"%s1% lassabb töltődés"
"[english]Attrib_SRifleChargeRate_Decreased"	"%s1% slower power charge"
"Attrib_ConstructionRate_Increased"	"%s1% gyorsabb építési sebesség"
"[english]Attrib_ConstructionRate_Increased"	"%s1% faster construction rate"
"Attrib_ConstructionRate_Decreased"	"%s1% lassabb építési sebesség"
"[english]Attrib_ConstructionRate_Decreased"	"%s1% slower construction rate"
"Attrib_RepairRate_Increased"	"%s1% gyorsabb javítási sebesség"
"[english]Attrib_RepairRate_Increased"	"%s1% faster repair rate"
"Attrib_RepairRate_Decreased"	"%s1% lassabb javítási sebesség"
"[english]Attrib_RepairRate_Decreased"	"%s1% slower repair rate"
"Attrib_ReloadTime_Increased"	"%s1% lassabb újratöltés"
"[english]Attrib_ReloadTime_Increased"	"%s1% slower reload time"
"Attrib_ReloadTime_Decreased"	"%s1% gyorsabb újratöltés"
"[english]Attrib_ReloadTime_Decreased"	"%s1% faster reload time"
"Attrib_BlastRadius_Increased"	"+%s1% robbanási sugár"
"[english]Attrib_BlastRadius_Increased"	"+%s1% explosion radius"
"Attrib_BlastRadius_Decreased"	"%s1% robbanási sugár"
"[english]Attrib_BlastRadius_Decreased"	"%s1% explosion radius"
"Attrib_ProjectileRange_Increased"	"+%s1% lőtávolság"
"[english]Attrib_ProjectileRange_Increased"	"+%s1% projectile range"
"Attrib_ProjectileRange_Decreased"	"%s1% lőtávolság"
"[english]Attrib_ProjectileRange_Decreased"	"%s1% projectile range"
"Attrib_ProjectileSpeed_Increased"	"+%s1% lövedéksebesség"
"[english]Attrib_ProjectileSpeed_Increased"	"+%s1% projectile speed"
"Attrib_ProjectileSpeed_Decreased"	"%s1% lövedéksebesség"
"[english]Attrib_ProjectileSpeed_Decreased"	"%s1% projectile speed"
"Attrib_MoveSpeed_Bonus"	"+%s1% gyorsabb mozgás viseléskor"
"[english]Attrib_MoveSpeed_Bonus"	"+%s1% faster move speed on wearer"
"Attrib_HealthFromPacks_Increased"	"+%s1% egészség mentőládákból viseléskor"
"[english]Attrib_HealthFromPacks_Increased"	"+%s1% health from packs on wearer"
"Attrib_HealthFromPacks_Decreased"	"%s1% egészség mentőládákból viseléskor"
"[english]Attrib_HealthFromPacks_Decreased"	"%s1% health from packs on wearer"
"Attrib_AmmoRegen"	"+%s1% lőszermennyiség regenerálás 5 másodpercenként viseléskor"
"[english]Attrib_AmmoRegen"	"+%s1% ammo regenerated every 5 seconds on wearer"
"Attrib_MetalRegen"	"+%s1 fémmennyiség regenerálás 5 másodpercenként viseléskor"
"[english]Attrib_MetalRegen"	"+%s1 metal regenerated every 5 seconds on wearer"
"Attrib_RocketLauncherSeeker"	"Lézerirányítású rakétát lő ki"
"[english]Attrib_RocketLauncherSeeker"	"Fires laser guided rockets"
"Attrib_ShovelDamageBoost"	"Ahogy a viselő sebződik, nő a mozgási
sebessége és az okozott sebzése
Használatkor blokkolja a gyógyítást"
"[english]Attrib_ShovelDamageBoost"	"Damage and move speed increase
as the user becomes injured
Blocks healing when in use"
"Attrib_StickyDetonateMode"	"Felrobbantja a célkereszt közelében levő tapadóbombákat"
"[english]Attrib_StickyDetonateMode"	"Detonates stickybombs near the crosshair"
"Attrib_StickyAirBurstMode"	"A kilőtt bomba felülettel érintkezve széthasad"
"[english]Attrib_StickyAirBurstMode"	"Launched bombs shatter on surfaces"
"Attrib_StickyArmTimePenalty"	"%s1 másodperccel hosszabb bombaélesítés"
"[english]Attrib_StickyArmTimePenalty"	"%s1 sec slower bomb arm time"
"Attrib_StickyArmTimeBonus"	"%s1 másodperccel rövidebb bombaélesítés"
"[english]Attrib_StickyArmTimeBonus"	"%s1 sec faster bomb arm time"
"Attrib_MiniCritAirborneEnemies"	"Mini kritikus találatok levegőben levő célon"
"[english]Attrib_MiniCritAirborneEnemies"	"Mini-crits airborne targets"
"Attrib_StickiesDetonateStickies"	"Meg tudja semmisíteni az ellenséges tapadóbombákat"
"[english]Attrib_StickiesDetonateStickies"	"Able to destroy enemy stickybombs"
"Attrib_SpeedBoostWhenActive"	"%s1% sebességnövelés, míg ez az aktív fegyver"
"[english]Attrib_SpeedBoostWhenActive"	"%s1% speed boost while active weapon"
"Attrib_ProvideOnActive"	"Míg a fegyver aktív:"
"[english]Attrib_ProvideOnActive"	"When weapon is active:"
"Attrib_MedicRegenBonus"	"+%s1% természetes regenerálódás"
"[english]Attrib_MedicRegenBonus"	"+%s1% natural regen rate"
"Attrib_MedicRegenPenalty"	"-%s1% természetes regenerálódás"
"[english]Attrib_MedicRegenPenalty"	"-%s1% natural regen rate"
"Attrib_Community_Description"	"Értékes közösségi közreműködők kapják"
"[english]Attrib_Community_Description"	"Given to valuable Community Contributors"
"Attrib_MedalIndex_Description"	"Kitüntetés: %s1"
"[english]Attrib_MedalIndex_Description"	"Medal no. %s1"
"Attrib_RocketJumpDmgReduction"	"%s1% sebzés rakétaugráskor"
"[english]Attrib_RocketJumpDmgReduction"	"%s1% blast damage from rocket jumps"
"Attrib_Selfmade_Description"	"Ezt én csináltam!"
"[english]Attrib_Selfmade_Description"	"I made this!"
"Attrib_DmgVsBuilding_Increased"	"%s1% sebzés építmények ellen"
"[english]Attrib_DmgVsBuilding_Increased"	"%s1% damage vs buildings"
"Attrib_DmgVsPlayer_Decreased"	"%s1% sebzés játékosok ellen"
"[english]Attrib_DmgVsPlayer_Decreased"	"%s1% damage vs players"
"Attrib_LunchboxAddsMaxHealth"	"+50 maximális egészséget ad 30 másodpercig"
"[english]Attrib_LunchboxAddsMaxHealth"	"Adds +50 max health for 30 seconds"
"Item_Giveaway_NoItem"	"Várakozás a tárgyra..."
"[english]Item_Giveaway_NoItem"	"Waiting for item..."
"Item_Found"	"%s1 ezt találta: %s2 %s3"
"[english]Item_Found"	"%s1 has found:: %s2 %s3"
"Item_Crafted"	"%s1 ezt készítette: %s2 %s3"
"[english]Item_Crafted"	"%s1 has crafted:: %s2 %s3"
"Item_BlacklistedInMatch"	"A '%s1' tárgyat letiltották a szerver kivétellistáján erre a versenyjátszmára."
"[english]Item_BlacklistedInMatch"	"Item '%s1' has been disabled in this tournament match by the server whitelist."
"community"	"Közösség"
"[english]community"	"Community"
"developer"	"Valve"
"[english]developer"	"Valve"
"selfmade"	"Saját készítésű"
"[english]selfmade"	"Self-Made"
"ReadAllAboutIt"	"Tudj meg róla mindent!"
"[english]ReadAllAboutIt"	"Read all about it!"
"Building_hud_tele_not_built"	"Nem épült
Teleport bejárat"
"[english]Building_hud_tele_not_built"	"Teleporter Entrance
Not Built"
"Loadout_OpenBackpack"	"Hátizsák kinyitása"
"[english]Loadout_OpenBackpack"	"Open your Backpack"
"Loadout_OpenBackpackDesc"	"(%s1 TÁRGY VAN BENNE)"
"[english]Loadout_OpenBackpackDesc"	"(%s1 ITEMS INSIDE)"
"Loadout_OpenBackpackDesc1"	"(1 TÁRGY VAN BENNE)"
"[english]Loadout_OpenBackpackDesc1"	"(1 ITEM INSIDE)"
"Loadout_OpenCraftingDesc"	"ÚJ TÁRGYAK KÉSZÍTÉSE A
HÁTIZSÁKBAN LEVŐ TÁRGYAK KOMBINÁLÁSÁVAL"
"[english]Loadout_OpenCraftingDesc"	"CONSTRUCT NEW ITEMS BY
COMBINING ITEMS IN YOUR BACKPACK"
"RDI_AB1"	"Szükséges: %s1, %s2"
"[english]RDI_AB1"	"Requires: %s1, %s2"
"RDI_ABC1"	"Szükséges: %s1 %s2, %s3"
"[english]RDI_ABC1"	"Requires: %s1 %s2, %s3"
"RDI_ABC2"	"Szükséges: %s1, %s2, %s3"
"[english]RDI_ABC2"	"Requires: %s1, %s2, %s3"
"RDO_AB1"	"Eredményez: %s1, %s2"
"[english]RDO_AB1"	"Produces: %s1, %s2"
"RDO_ABC1"	"Eredményez: %s1 %s2, %s3"
"[english]RDO_ABC1"	"Produces: %s1 %s2, %s3"
"RDO_ABC2"	"Eredményez: %s1, %s2, %s3"
"[english]RDO_ABC2"	"Produces: %s1, %s2, %s3"
"Attrib_DmgAppliesToSappers"	"A sebzés eltávolítja a mentesítőket"
"[english]Attrib_DmgAppliesToSappers"	"Damage removes Sappers"
"Attrib_BleedingDuration"	"Találatkor: Vérzés %s1 másodpercig"
"[english]Attrib_BleedingDuration"	"On Hit: Bleed for %s1 seconds"
"Gametype_Training"	"Gyakorló mód"
"[english]Gametype_Training"	"Training Mode"
"ConfirmTitle"	"BIZTOS VAGY BENNE?"
"[english]ConfirmTitle"	"ARE YOU SURE?"
"ConfirmButtonText"	"TOVÁBB"
"[english]ConfirmButtonText"	"CONTINUE"
"ChallengeTitle"	"%challengeclass%"
"[english]ChallengeTitle"	"%challengeclass%"
"ChallengeSubText"	"Nem teszel vele egy próbát?"
"[english]ChallengeSubText"	"Why don't you give him a shot?"
"ChallengeSubTextB"	"Nem teszel vele egy próbát?"
"[english]ChallengeSubTextB"	"Why don't you give her a shot?"
"ChallengeRecord"	"Ezt szárnyald túl:"
"[english]ChallengeRecord"	"Beat this:"
"ChallengeDetails"	"%s1, mint %s2"
"[english]ChallengeDetails"	"%s1 as a %s2"
"FriendsList"	"Mind a %friendsplaying% játékban levő barát megtekintése"
"[english]FriendsList"	"See all %friendsplaying% friends playing"
"MMenu_StartPlaying"	"Kezdődjön a játék"
"[english]MMenu_StartPlaying"	"Start Playing"
"MMenu_ChangeServer"	"Szerverváltás"
"[english]MMenu_ChangeServer"	"Change Server"
"MMenu_CharacterSetup"	"Karakter-felszerelés"
"[english]MMenu_CharacterSetup"	"Character Setup"
"MMenu_Achievements"	"Teljesítmények és statisztikák"
"[english]MMenu_Achievements"	"Achievements & Stats"
"MMenu_NoRecentAchievements"	"%currentachievements% darabot nyertél el a %totalachievements% összes teljesítményből."
"[english]MMenu_NoRecentAchievements"	"You've earned %currentachievements% of %totalachievements% achievements."
"MMenu_RecentAchievements"	"Közelmúltbeli teljesítményeid:"
"[english]MMenu_RecentAchievements"	"Your recent achievements:"
"MMenu_ViewAll"	"Összes megtekintése"
"[english]MMenu_ViewAll"	"View All"
"MMenu_Tooltip_Training"	"Gyakorlás"
"[english]MMenu_Tooltip_Training"	"Training"
"MMenu_Tooltip_NewUserForum"	"Új felhasználói fórum"
"[english]MMenu_Tooltip_NewUserForum"	"New User Forum"
"MMenu_Tooltip_ReportBug"	"Hibajelentés küldése"
"[english]MMenu_Tooltip_ReportBug"	"Report a Bug"
"MMenu_Tooltip_MutePlayers"	"Játékosok némítása"
"[english]MMenu_Tooltip_MutePlayers"	"Mute Players"
"MMenu_Tooltip_Commentary"	"Fejlesztői kommentár"
"[english]MMenu_Tooltip_Commentary"	"Developer Commentary"
"MMenu_MOTD_Show"	"ÜZENETEK"
"[english]MMenu_MOTD_Show"	"MESSAGES"
"MMenu_MOTD_Hide"	"X"
"[english]MMenu_MOTD_Hide"	"X"
"MMenu_TutorialHighlight_Title"	"Úgy tűnik, most játszol először a TF2-vel..."
"[english]MMenu_TutorialHighlight_Title"	"Looks like it's your first time playing TF2..."
"MMenu_TutorialHighlight_Title2"	"Az óta, hogy legutóbb játszottál, már gyakorló mód is van..."
"[english]MMenu_TutorialHighlight_Title2"	"Since you last played, we've added training..."
"MMenu_ViewNewUserForums"	"Új felhasználók fórumának megtekintése"
"[english]MMenu_ViewNewUserForums"	"View new user forums"
"MMenu_NewUserForumHighlight_Title"	"Új felhasználók fóruma"
"[english]MMenu_NewUserForumHighlight_Title"	"New User Forum"
"MMenu_NewUserForumHighlight_Text"	"Kialakítottunk egy fórumot, ahol az új felhasználók beszélgethetnek. Ha kérdéseid vannak, ez a legjobb hely feltenni őket."
"[english]MMenu_NewUserForumHighlight_Text"	"We've setup some forums for new users to talk. If you've got questions, here's a great place to ask them."
"LoadoutExplanation_Title"	"Felszerelések"
"[english]LoadoutExplanation_Title"	"Loadouts"
"BackpackExplanation_Title"	"Hátizsák"
"[english]BackpackExplanation_Title"	"Backpack"
"BackpackExplanation_Text"	"Kattints ide a hátizsákod kinyitásához. A hátizsákod tartalmazza a játék során talált összes tárgyat."
"[english]BackpackExplanation_Text"	"Click here to open your backpack. Your backpack contains all the items you've found while playing."
"ExplanationExplanation_Title"	"Lemaradtál valamiről?"
"[english]ExplanationExplanation_Title"	"Missed something?"
"BackpackItemsExplanation_Title"	"Hátizsák"
"[english]BackpackItemsExplanation_Title"	"Backpack"
"BackpackItemsExplanation_Text"	"Itt megtalálod az összes tárgyadat. Rájuk kattintva és máshova húzva tetszőlegesen átrendezheted őket.

Azok a tárgyak, amik használva vannak egy osztály felszerelésében 'felszerelt' jelölést kapnak."
"[english]BackpackItemsExplanation_Text"	"Here you'll find all your items. You can click and drag them to rearrange to your liking.

Items that are equipped in a class's loadout with be marked as 'equipped'."
"BackpackPagesExplanation_Title"	"Hátizsák-oldalak"
"[english]BackpackPagesExplanation_Title"	"Backpack Pages"
"BackpackPagesExplanation_Text"	"A hátizsákodban több oldalnyi tárgy van. Ezeket a gombokat használva lapozhatsz köztük."
"[english]BackpackPagesExplanation_Text"	"Your backpack has multiple pages of items. Use these buttons to flip between them."
"BackpackDeleteExplanation_Title"	"Tárgyak törlése"
"[english]BackpackDeleteExplanation_Title"	"Deleting Items"
"CraftingRecipesExplanation_Title"	"Tervrajzok"
"[english]CraftingRecipesExplanation_Title"	"Blueprints"
"DiscardItemsExplanation_Title"	"Eldobás"
"[english]DiscardItemsExplanation_Title"	"Discarding"
"DiscardItemsExplanation_Text"	"Új tárgyat találtál, de nincs hely a hátizsákodban, ahova tehetnéd. El kell döntened, hogy eldobod-e az új tárgyat, vagy törlöd a hátizsákodban levők valamelyikét."
"[english]DiscardItemsExplanation_Text"	"You've found a new item, but don't have any room in your backpack to store it. You must choose between discarding the new item, or deleting one of the items in your backpack."
"DiscardButtonExplanation_Title"	"Új tárgy eldobása"
"[english]DiscardButtonExplanation_Title"	"Discard New Item"
"DiscardButtonExplanation_Text"	"A kapott új tárgy eldobásához kattints erre a gombra. A tárgy végérvényesen megsemmisül."
"[english]DiscardButtonExplanation_Text"	"To discard the new item you've received, click this button. The item will be permanently destroyed."
"DiscardDeleteExplanation_Title"	"Tárgyak törlése"
"[english]DiscardDeleteExplanation_Title"	"Deleting Items"
"DiscardDeleteExplanation_Text"	"A hátizsákodban levő egyik tárgy törléséhez válassz ki egy tárgyat, majd annak végleges törléséhez kattints erre a gombra. A CTRL billentyű nyomva tartásával több tárgyat is kiválaszthatsz."
"[english]DiscardDeleteExplanation_Text"	"To delete an item in your backpack, select an item and click this button to permanently delete it. You can select multiple items by holding down the CTRL key."
"Button_ReplayTraining"	"&ÚJRA"
"[english]Button_ReplayTraining"	"&REPLAY"
"Button_NextTraining"	"&TOVÁBB"
"[english]Button_NextTraining"	"&NEXT"
"Button_QuitTraining"	"&KÉSZ"
"[english]Button_QuitTraining"	"&DONE"
"Attrib_WrenchNumber"	"%s1. franciakulcs"
"[english]Attrib_WrenchNumber"	"Wrench no. %s1"
"Attrib_TurnToGold"	"Ősi hatalommal felvértezve"
"[english]Attrib_TurnToGold"	"Imbued with an ancient power"
}
}
